Roll Year,Jurisdiction,Roll Number (Formatted),Mailing Address Line 6,Situs Unit Number,Situs Street Address,Previous Roll Value,Actual Value Land Total,Actual Value Impr Total,Actual Value Total
2023,District of Oak Bay,01-0001-00,V8R 1G2,,2291 CEDAR HILL CROSS,9629000,8992000,1116000,10108000
2023,District of Oak Bay,01-0001-00,V8R 1G2,,2291 CEDAR HILL CROSS,9629000,8992000,1116000,10108000
2023,District of Oak Bay,01-0002-00,V8R 0A7,, ,76100,82600,0,82600
2023,District of Oak Bay,01-0002-01,V8R 0A7,, ,91300,99200,0,99200
2023,District of Oak Bay,01-0003-00,V6Z 0B9,, ISLANDS,1604000,1855000,0,1855000
2023,District of Oak Bay,01-0005-00,V8R 1G2,, MARY TOD,3858000,3858000,0,3858000
2023,District of Oak Bay,01-0008-00,V4N 0E8,, ,16666000,0,9611000,9611000
2023,District of Oak Bay,01-0009-01,T2P 4L4,, ,3126000,0,1563000,1563000
2023,District of Oak Bay,01-0010-00,V8S 2J5,,137 BARKLEY,2302000,2365000,379000,2744000
2023,District of Oak Bay,01-0012-00,V8R 1G2,, CADBORO BAY,1395200,1511000,5700,1516700
2023,District of Oak Bay,01-0014-00,V8S 2L9,,207 BEACH,3680000,2653000,882000,3535000
2023,District of Oak Bay,01-0015-00,V8S 2L9,,205 BEACH,2508000,2019000,322000,2341000
2023,District of Oak Bay,01-0016-00,V8P 4P5,,820 VICTORIA,4530000,3635000,1575000,5210000
2023,District of Oak Bay,01-0021-00,V8R 1G2,, MONTEREY,1864000,2145000,0,2145000
2023,District of Oak Bay,01-0022-00,V8R 1G2,, MONTEREY,1385000,1597000,0,1597000
2023,District of Oak Bay,01-0023-00,V8S 4T7,,458 MONTEREY,2071000,1614000,622000,2236000
2023,District of Oak Bay,01-0024-00,V8S 2P2,,2199 LAFAYETTE,2074000,1553000,688000,2241000
2023,District of Oak Bay,01-0025-00,V8S 4T7,,444 MONTEREY,2437000,2215000,417000,2632000
2023,District of Oak Bay,01-0026-00,V6K 1C8,,479 MONTEREY,1894000,1514000,552000,2066000
2023,District of Oak Bay,01-0027-00,V8S 4T8,,487 MONTEREY,1815000,1548000,398000,1946000
2023,District of Oak Bay,01-0028-00,V8S 4T8,,513 MONTEREY,3666000,2074000,1965000,4039000
2023,District of Oak Bay,01-0029-00,V8S 4Z5,,444 TRANSIT,2408000,2377000,438000,2815000
2023,District of Oak Bay,01-0030-00,V8S 4Z5,,476 TRANSIT,2672000,1733000,1506000,3239000
2023,District of Oak Bay,01-0031-00,V8S 2M4,,450 BEACH,2618000,2307000,749000,3056000
2023,District of Oak Bay,01-0032-00,V8S 2M4,,430 BEACH,3487000,2533000,1587000,4120000
2023,District of Oak Bay,01-0033-00,V8S 2M4,,418 BEACH,4248000,2480000,2309000,4789000
2023,District of Oak Bay,01-0034-00,V8S 4X4,,483 ST. PATRICK,1761000,1542000,362000,1904000
2023,District of Oak Bay,01-0034-01,V8S 4Z4,,406 BEACH,1830000,1979000,158000,2137000
2023,District of Oak Bay,01-0035-00,V8S 4Z5,,500 TRANSIT,2266000,2322000,386000,2708000
2023,District of Oak Bay,01-0036-00,V8S 4Z5,,520 TRANSIT,1755000,1915000,200000,2115000
2023,District of Oak Bay,01-0037-00,V8S 4Z5,,590 TRANSIT,2912000,2724000,774000,3498000
2023,District of Oak Bay,01-0038-00,V8S 4Z5,,600 TRANSIT,2370000,2086000,735000,2821000
2023,District of Oak Bay,01-0039-00,V8S 4Z5,,608 TRANSIT,1800000,1993000,191000,2184000
2023,District of Oak Bay,01-0040-00,V8S 4Z5,,628 TRANSIT,3679000,2298000,2144000,4442000
2023,District of Oak Bay,01-0041-00,V8N 1B8,,607 ST. PATRICK,1247400,1302000,41600,1343600
2023,District of Oak Bay,01-0042-00,V8S 4X4,,599 ST. PATRICK,1673000,1302000,525000,1827000
2023,District of Oak Bay,01-0043-00,V8S 4X4,,591 ST. PATRICK,1259000,1300000,57200,1357200
2023,District of Oak Bay,01-0044-00,V8S 4X4,,583 ST. PATRICK,1564000,1522000,154000,1676000
2023,District of Oak Bay,01-0044-00,V8S 4X4,,583 ST. PATRICK,1564000,1522000,154000,1676000
2023,District of Oak Bay,01-0045-00,V8S 4X4,,575 ST. PATRICK,1544000,1524000,1744000,3268000
2023,District of Oak Bay,01-0046-00,V8S 4X4,,555 ST. PATRICK,1572000,1519000,187000,1706000
2023,District of Oak Bay,01-0046-00,V8S 4X4,,555 ST. PATRICK,1572000,1519000,187000,1706000
2023,District of Oak Bay,01-0047-00,V8S 4X4,,563 ST. PATRICK,1650000,1515000,259000,1774000
2023,District of Oak Bay,01-0048-00,V8S 4X4,,509 ST. PATRICK,2221000,1784000,629000,2413000
2023,District of Oak Bay,01-0049-00,V8S 4X4,,499 ST. PATRICK,2425000,2103000,530000,2633000
2023,District of Oak Bay,01-0050-00,V8S 4Z6,,764 TRANSIT,1904000,1882000,180000,2062000
2023,District of Oak Bay,01-0052-00,V8S 2V1,,929 ISLAND,1506500,1532000,103000,1635000
2023,District of Oak Bay,01-0052-00,V8X 3T3,,929 ISLAND,1506500,1532000,103000,1635000
2023,District of Oak Bay,01-0055-00,V8R 1G2,,577 BEACH,657000,757000,0,757000
2023,District of Oak Bay,01-0055-00,V8R 1G2,,577 BEACH,657000,757000,0,757000
2023,District of Oak Bay,01-0055-00,V8R 1G2,,577 BEACH,657000,757000,0,757000
2023,District of Oak Bay,01-0056-00,V8S 2M6,,495 BEACH,1631000,1431000,69900,1500900
2023,District of Oak Bay,01-0057-00,V8S 4Z4,,681 TRANSIT,2110000,2010000,514000,2524000
2023,District of Oak Bay,01-0058-00,V8R 1G2,, BEACH,113000,132000,0,132000
2023,District of Oak Bay,01-0060-00,V8S 2Z3,,2453 MCNEILL,1403000,1193000,315000,1508000
2023,District of Oak Bay,01-0061-00,V8S 2Z2,,2467 MCNEILL,1286000,1201000,175000,1376000
2023,District of Oak Bay,01-0062-00,V8S 2Z3,,2479 MCNEILL,1413000,1209000,307000,1516000
2023,District of Oak Bay,01-0063-00,V8S 2Z3,,2485 MCNEILL,2477000,1217000,1648000,2865000
2023,District of Oak Bay,01-0064-00,V8S 2Z3,,2495 MCNEILL,1852000,1237000,814000,2051000
2023,District of Oak Bay,01-0067-00,V8S 5B4,,966 BYNG,2681000,1863000,1094000,2957000
2023,District of Oak Bay,01-0116-00,V8R 5A6,,1897 FOUL BAY,1301000,903000,494000,1397000
2023,District of Oak Bay,01-0116-00,V8R 5A6,,1897 FOUL BAY,1301000,903000,494000,1397000
2023,District of Oak Bay,01-0116-00,V8T 2G2,,1897 FOUL BAY,1301000,903000,494000,1397000
2023,District of Oak Bay,01-0116-00,V8T 2G2,,1897 FOUL BAY,1301000,903000,494000,1397000
2023,District of Oak Bay,01-0117-00,V8R 5A6,,1899 FOUL BAY,928000,902000,112000,1014000
2023,District of Oak Bay,01-0117-00,V8R 5A6,,1899 FOUL BAY,928000,902000,112000,1014000
2023,District of Oak Bay,01-0118-00,V8R 1T3,,2023 GOLDSMITH,1100000,954000,259000,1213000
2023,District of Oak Bay,01-0119-00,V8R 1T3,,2029 GOLDSMITH,1146000,955000,466000,1421000
2023,District of Oak Bay,01-0120-01,V8R 1T3,,2033 GOLDSMITH,1241000,955000,428000,1383000
2023,District of Oak Bay,01-0120-02,V8R 1T3,,2039 GOLDSMITH,1297000,955000,500000,1455000
2023,District of Oak Bay,01-0121-00,V8R 1T5,,2045 GOLDSMITH,1057000,955000,203000,1158000
2023,District of Oak Bay,01-0122-00,V8R 1T5,,2055 GOLDSMITH,934900,956000,65700,1021700
2023,District of Oak Bay,01-0123-00,V8R 1T5,,2065 GOLDSMITH,959800,956000,95800,1051800
2023,District of Oak Bay,01-0124-00,V8R 1T5,,2069 GOLDSMITH,1017000,956000,155000,1111000
2023,District of Oak Bay,01-0125-00,V8R 1T5,,2075 GOLDSMITH,1218000,956000,302000,1258000
2023,District of Oak Bay,01-0125-00,V8R 1T5,,2075 GOLDSMITH,1218000,956000,302000,1258000
2023,District of Oak Bay,01-0126-00,V8R 1T5,,2085 GOLDSMITH,1021000,956000,160000,1116000
2023,District of Oak Bay,01-0127-00,V8R 1T5,,2095 GOLDSMITH,1028000,1025000,94300,1119300
2023,District of Oak Bay,01-0128-00,V8R 1G2,, FOUL BAY,449000,481000,0,481000
2023,District of Oak Bay,01-0129-00,V8R 1G2,, FOUL BAY,222000,255000,0,255000
2023,District of Oak Bay,01-0130-00,V8S 4G2,,1011 AMPHION,316000,328000,10000,338000
2023,District of Oak Bay,01-0134-00,V8R 1G2,, BRIGHTON,2900,3100,0,3100
2023,District of Oak Bay,01-0135-00,V8S 4G2,,1007 AMPHION,199000,213000,0,213000
2023,District of Oak Bay,01-0136-00,V8S 4G2,,1003 AMPHION,232100,234000,11700,245700
2023,District of Oak Bay,01-0137-00,V8S 2E4,,2002 BRIGHTON,1316000,1222000,200000,1422000
2023,District of Oak Bay,01-0139-01,V8R 1G2,, FOUL BAY,449000,481000,0,481000
2023,District of Oak Bay,01-0140-00,V8S 4J2,,1054 FOUL BAY,1266000,1050000,333000,1383000
2023,District of Oak Bay,01-0141-00,V0N 1P0,,1958 GRANITE,102000,110000,0,110000
2023,District of Oak Bay,01-0142-00,V8S 4J2,,1058 FOUL BAY,879000,644000,314000,958000
2023,District of Oak Bay,01-0143-00,V9R 2P1,,1056 FOUL BAY,785100,792000,50600,842600
2023,District of Oak Bay,01-0145-00,V8P 3C8,,960 FOUL BAY,2726000,2076000,871000,2947000
2023,District of Oak Bay,01-0147-00,V8S 4H8,,948 FOUL BAY,2092000,1472000,806000,2278000
2023,District of Oak Bay,01-0151-00,V8S 4H8,,936 FOUL BAY,1760000,1217000,760000,1977000
2023,District of Oak Bay,01-0158-00,V8S 2G9,,1915 CRESCENT,2064000,1890000,440000,2330000
2023,District of Oak Bay,01-0159-00,V8S 2G9,,1921 CRESCENT,2533900,2271000,106000,2377000
2023,District of Oak Bay,01-0160-01,V8S 2G9,,1927 CRESCENT,5970000,2283000,3258000,5541000
2023,District of Oak Bay,01-0160-02,V8S 2G9,,1933 CRESCENT,3025000,2254000,654000,2908000
2023,District of Oak Bay,01-0162-01,T6B 3L9,,1941 CRESCENT,4737000,2287000,2732000,5019000
2023,District of Oak Bay,01-0166-00,V8S 2G9,,1973 CRESCENT,415900,365000,15700,380700
2023,District of Oak Bay,01-0167-00,V8S 2G9,,1973 CRESCENT,2590000,2146000,303000,2449000
2023,District of Oak Bay,01-0169-00,V8S 2G9,,1989 CRESCENT,3787000,2983000,660000,3643000
2023,District of Oak Bay,01-0170-01,V8S 4G6,,309 FOUL BAY,2589000,2526000,566000,3092000
2023,District of Oak Bay,01-0175-00,V8S 4G6,,337 FOUL BAY,1965000,1756000,577000,2333000
2023,District of Oak Bay,01-0176-00,V8S 4G6,,339 FOUL BAY,2902000,2059000,1382000,3441000
2023,District of Oak Bay,01-0176-00,V8S 4G6,,339 FOUL BAY,2902000,2059000,1382000,3441000
2023,District of Oak Bay,01-0177-00,V8S 4G6,, FOUL BAY,95500,115000,0,115000
2023,District of Oak Bay,01-0178-00,V8S 4G6,,345 FOUL BAY,147000,179000,0,179000
2023,District of Oak Bay,01-0183-10,V8S 2H4,,2169 CRESCENT,3327000,2509000,682000,3191000
2023,District of Oak Bay,01-0185-00,V8S 2H4,,2141 CRESCENT,2446000,1384000,1318000,2702000
2023,District of Oak Bay,01-0186-00,V8S 2H4,,2133 CRESCENT,1412000,1384000,147000,1531000
2023,District of Oak Bay,01-0186-00,T0L 1K0,,2133 CRESCENT,1412000,1384000,147000,1531000
2023,District of Oak Bay,01-0187-00,V8S 4K1,,2121 MARNE,1433000,1384000,151000,1535000
2023,District of Oak Bay,01-0188-00,V8S 4K1,,2115 MARNE,1423000,1384000,140000,1524000
2023,District of Oak Bay,01-0189-00,V8S 2H4,,2107 CRESCENT,1407000,1384000,120000,1504000
2023,District of Oak Bay,01-0190-00,V8S 2G9,,2093 CRESCENT,2460000,1384000,1392000,2776000
2023,District of Oak Bay,01-0191-00,V8S 2G9,,2087 CRESCENT,1556000,1263000,424000,1687000
2023,District of Oak Bay,01-0192-00,V8S 2G9,,2079 CRESCENT,1301000,1263000,132000,1395000
2023,District of Oak Bay,01-0193-00,V8S 2G9,,2073 CRESCENT,1581000,1263000,455000,1718000
2023,District of Oak Bay,01-0194-00,V8P 2E4,,2067 CRESCENT,2507000,1263000,1560000,2823000
2023,District of Oak Bay,01-0196-00,V8S 4J8,,2078 MARNE,2852000,2467000,169000,2636000
2023,District of Oak Bay,01-0203-02,V8S 4J9,,2120 MARNE,4158000,2301000,1795000,4096000
2023,District of Oak Bay,01-0203-04,V8S 4J8,,2086 MARNE,3468000,2213000,1232000,3445000
2023,District of Oak Bay,01-0203-05,V8S 4J8,,2092 MARNE,3886000,2375000,1509000,3884000
2023,District of Oak Bay,01-0204-00,V8Y 1E8,,2012 OAK BAY,1018000,601000,554000,1155000
2023,District of Oak Bay,01-0204-00,V8Y 1E8,,2012 OAK BAY,1018000,601000,554000,1155000
2023,District of Oak Bay,01-0204-01,V8R 1G2,, FOUL BAY,11700,11700,0,11700
2023,District of Oak Bay,01-0205-00,V8Y 1E8,,1547 FOUL BAY,847600,864000,65900,929900
2023,District of Oak Bay,01-0206-00,V8R 5A1,,1569 FOUL BAY,1044000,918000,228000,1146000
2023,District of Oak Bay,01-0207-00,V8M 1L4,,1593 FOUL BAY,952000,918000,116000,1034000
2023,District of Oak Bay,01-0208-00,V8R 1H6,,2019 CHAUCER,1082000,1012000,159000,1171000
2023,District of Oak Bay,01-0209-00,V8R 1H6,,2025 CHAUCER,1089000,1007000,170000,1177000
2023,District of Oak Bay,01-0210-00,V8R 1H6,,2033 CHAUCER,1057000,1002000,148000,1150000
2023,District of Oak Bay,01-0211-00,V8R 1H6,,2041 CHAUCER,1048000,997000,141000,1138000
2023,District of Oak Bay,01-0224-00,V8R 6W2,,2080 OAK BAY,20030000,7594000,12443000,20037000
2023,District of Oak Bay,01-0230-00,V8S 2W3,,2024 OAK BAY,1062200,1053000,13700,1066700
2023,District of Oak Bay,01-0231-00,V8N 2Z6,,2014 OAK BAY,2183900,2160000,35400,2195400
2023,District of Oak Bay,01-0231-00,V8N 2Z6,,2014 OAK BAY,2183900,2160000,35400,2195400
2023,District of Oak Bay,01-0233-00,V8R 5A2,,1605 FOUL BAY,820800,807000,89800,896800
2023,District of Oak Bay,01-0234-00,V8R 5A2,,1633 FOUL BAY,1112000,807000,426000,1233000
2023,District of Oak Bay,01-0235-00,V8R 1H7,,2014 CHAUCER,1474000,819000,779000,1598000
2023,District of Oak Bay,01-0236-00,V8T 3C1,,1665 FOUL BAY,945000,916000,110000,1026000
2023,District of Oak Bay,01-0237-00,V8R 5A2,,1683 FOUL BAY,1225000,916000,360000,1276000
2023,District of Oak Bay,01-0238-00,V8R 5A2,,1695 FOUL BAY,944000,916000,128000,1044000
2023,District of Oak Bay,01-0239-00,V8R 1L8,,2021 BYRON,1116000,1077000,135000,1212000
2023,District of Oak Bay,01-0240-01,V8R 1L8,,2027 BYRON,1582000,1078000,662000,1740000
2023,District of Oak Bay,01-0240-02,V8R 1L8,,2035 BYRON,1651000,1077000,740000,1817000
2023,District of Oak Bay,01-0241-00,V8R 1L8,,2039 BYRON,1130000,1077000,151000,1228000
2023,District of Oak Bay,01-0242-00,V8R 1L8,,2047 BYRON,1107000,1077000,125000,1202000
2023,District of Oak Bay,01-0243-00,V8R 1L8,,2059 BYRON,1514000,1077000,633000,1710000
2023,District of Oak Bay,01-0244-00,V8R 1L8,,2079 BYRON,1051600,1077000,71700,1148700
2023,District of Oak Bay,01-0245-00,V8R 1T5,,2083 BYRON,1042600,1077000,59100,1136100
2023,District of Oak Bay,01-0246-00,V8Z 2N4,,2087 BYRON,1073800,1077000,90200,1167200
2023,District of Oak Bay,01-0246-00,V8R 1L8,,2087 BYRON,1073800,1077000,90200,1167200
2023,District of Oak Bay,01-0247-00,V8R 1L8,,2089 BYRON,1241000,1077000,279000,1356000
2023,District of Oak Bay,01-0247-00,V8R 1L8,,2089 BYRON,1241000,1077000,279000,1356000
2023,District of Oak Bay,01-0248-00,V8R 1L8,,2091 BYRON,1079900,1077000,108000,1185000
2023,District of Oak Bay,01-0249-00,V8R 1L8,,2093 BYRON,1044400,1077000,61200,1138200
2023,District of Oak Bay,01-0250-00,V8R 5L6,,1684 ELGIN,1295000,1023000,370000,1393000
2023,District of Oak Bay,01-0251-00,V8R 1H7,,2096 CHAUCER,1225000,1077000,293000,1370000
2023,District of Oak Bay,01-0252-00,V8R 1H7,,2092 CHAUCER,1469000,1077000,546000,1623000
2023,District of Oak Bay,01-0253-00,V8R 1H7,,2090 CHAUCER,1126000,1077000,173000,1250000
2023,District of Oak Bay,01-0254-00,V8R 1H7,,2086 CHAUCER,1833000,1077000,935000,2012000
2023,District of Oak Bay,01-0255-00,V8R 1H7,,2080 CHAUCER,1078700,1077000,102000,1179000
2023,District of Oak Bay,01-0256-00,V8R 1H7,,2072 CHAUCER,1042100,1077000,64000,1141000
2023,District of Oak Bay,01-0257-00,V8R 1H7,,2062 CHAUCER,1103000,1077000,140000,1217000
2023,District of Oak Bay,01-0258-00,,,2052 CHAUCER,1143000,1077000,179000,1256000
2023,District of Oak Bay,01-0259-00,V8R 1H7,,2046 CHAUCER,1098000,1077000,134000,1211000
2023,District of Oak Bay,01-0259-00,V8R 1H7,,2046 CHAUCER,1098000,1077000,134000,1211000
2023,District of Oak Bay,01-0260-00,S4V 2Z7,,2040 CHAUCER,1167000,1077000,222000,1299000
2023,District of Oak Bay,01-0261-00,V8R 1H7,,2034 CHAUCER,2057000,1077000,1232000,2309000
2023,District of Oak Bay,01-0262-00,V8R 1H7,,2026 CHAUCER,2173000,1078000,1349000,2427000
2023,District of Oak Bay,01-0263-00,V8R 1H7,,2020 CHAUCER,1282000,1078000,326000,1404000
2023,District of Oak Bay,01-0264-00,V8R 1L9,,2010 BYRON,884300,916000,48200,964200
2023,District of Oak Bay,01-0265-00,V8R 5A3,,1699 FOUL BAY,898300,916000,58000,974000
2023,District of Oak Bay,01-0266-00,V8R 5A3,,1701 FOUL BAY,894900,916000,57800,973800
2023,District of Oak Bay,01-0267-00,V8R 5A3,,1703 FOUL BAY,891700,916000,58700,974700
2023,District of Oak Bay,01-0269-00,V8R 1N7,,2029 MILTON,1100000,1078000,118000,1196000
2023,District of Oak Bay,01-0270-00,V8R 1N7,,2033 MILTON,1115000,1078000,124000,1202000
2023,District of Oak Bay,01-0270-00,V8R 1N7,,2033 MILTON,1115000,1078000,124000,1202000
2023,District of Oak Bay,01-0271-00,V8V 2C2,,2039 MILTON,1044500,1078000,55200,1133200
2023,District of Oak Bay,01-0272-00,V8R 1N7,,2043 MILTON,1057700,1078000,68000,1146000
2023,District of Oak Bay,01-0277-00,V8R 5L8,,1778 ELGIN,1019000,969000,133000,1102000
2023,District of Oak Bay,01-0278-00,V8R 5L8,,1742 ELGIN,1091000,1023000,159000,1182000
2023,District of Oak Bay,01-0279-00,V8R 1L9,,2094 BYRON,1109000,1077000,147000,1224000
2023,District of Oak Bay,01-0280-00,V8R 1L9,,2092 BYRON,1061500,1077000,80800,1157800
2023,District of Oak Bay,01-0281-00,V8R 1L9,,2090 BYRON,1249000,1077000,289000,1366000
2023,District of Oak Bay,01-0282-00,V8R 1L9,,2086 BYRON,1548000,1077000,612000,1689000
2023,District of Oak Bay,01-0283-00,V8R 1L9,,2078 BYRON,1125000,1077000,145000,1222000
2023,District of Oak Bay,01-0284-00,V8R 1L9,,2064 BYRON,1064800,1077000,86400,1163400
2023,District of Oak Bay,01-0285-00,V8R 1L9,,2052 BYRON,1416000,1258000,294000,1552000
2023,District of Oak Bay,01-0286-00,V8R 1L9,,2050 BYRON,1583000,1077000,668000,1745000
2023,District of Oak Bay,01-0287-00,V8R 1L9,,2038 BYRON,802000,840000,33100,873100
2023,District of Oak Bay,01-0288-00,V8R 1L9,,2034 BYRON,1034600,1067000,61800,1128800
2023,District of Oak Bay,01-0289-00,V8X 5C7,,2028 BYRON,1040000,1077000,53200,1130200
2023,District of Oak Bay,01-0290-00,V8R 1L9,,2022 BYRON,1118000,1078000,137000,1215000
2023,District of Oak Bay,01-0291-00,V8R 1N9,,2002 MILTON,929000,826000,176000,1002000
2023,District of Oak Bay,01-0292-00,V8R 1N9,,2010 MILTON,957000,923000,116000,1039000
2023,District of Oak Bay,01-0293-00,V3A 5A8,,1729 FOUL BAY,895900,918000,63100,981100
2023,District of Oak Bay,01-0294-00,V8R 1N9,,2020 MILTON,1166200,1161000,117000,1278000
2023,District of Oak Bay,01-0294-00,V8R 1N9,,2020 MILTON,1166200,1161000,117000,1278000
2023,District of Oak Bay,01-0296-00,V8R 1N9,,2030 MILTON,1618000,995000,792000,1787000
2023,District of Oak Bay,01-0296-00,V6K 4T5,,2030 MILTON,1618000,995000,792000,1787000
2023,District of Oak Bay,01-0297-00,V8N 1K7,,2034 MILTON,1033700,1083000,0,1083000
2023,District of Oak Bay,01-0298-00,V8N 1K7,,2038 MILTON,1819000,1083000,923000,2006000
2023,District of Oak Bay,01-0299-00,V8R 1N9,,2044 MILTON,1760000,1083000,916000,1999000
2023,District of Oak Bay,01-0300-00,V8R 1N9,,2050 MILTON,1303000,1265000,147000,1412000
2023,District of Oak Bay,01-0301-00,V8R 1N9,,2068 MILTON,1390000,1265000,244000,1509000
2023,District of Oak Bay,01-0302-00,V8R 1N9,,2076 MILTON,1514000,1083000,573000,1656000
2023,District of Oak Bay,01-0303-00,V8R 1N9,,2080 MILTON,1238000,1083000,286000,1369000
2023,District of Oak Bay,01-0304-00,V8R 1N9,,2084 MILTON,1146000,1083000,159000,1242000
2023,District of Oak Bay,01-0308-00,V8R 1G2,, SATELLITE,44400,51100,0,51100
2023,District of Oak Bay,01-0309-00,V8R 1H3,,2395 OAK BAY,1499000,1488000,141000,1629000
2023,District of Oak Bay,01-0310-00,V8Z 3G3,,1447 NEWPORT,2484000,1302000,1713000,3015000
2023,District of Oak Bay,01-0311-00,V8S 5G1,,1435 NEWPORT,1547000,1244000,433000,1677000
2023,District of Oak Bay,01-0312-00,V8S 5G1,,1425 NEWPORT,1364000,1244000,254000,1498000
2023,District of Oak Bay,01-0313-00,V5Z 2L1,,1413 NEWPORT,2485000,1428000,1389000,2817000
2023,District of Oak Bay,01-0316-00,V8S 2N9,,1494 BEACH,2202000,2121000,281000,2402000
2023,District of Oak Bay,01-0317-00,V8S 2N9,,1484 BEACH,2258000,2200000,286000,2486000
2023,District of Oak Bay,01-0318-00,V8S 2N8,,1480 BEACH,3020000,2226000,1097000,3323000
2023,District of Oak Bay,01-0333-00,V8W 9T5,, ,1400,1500,0,1500
2023,District of Oak Bay,01-0334-00,V8S 3B4,,2657 ORCHARD,1294000,1225000,156000,1381000
2023,District of Oak Bay,01-0335-00,V8S 3B4,,2663 ORCHARD,1462000,1224000,355000,1579000
2023,District of Oak Bay,01-0341-00,V8X 4C9,,1270 BEACH,9333000,3693000,6588000,10281000
2023,District of Oak Bay,01-0341-00,V8X 4C9,,1270 BEACH,9333000,3693000,6588000,10281000
2023,District of Oak Bay,01-0343-00,V8R 6A7,,1260 BEACH,2307000,1956000,681000,2637000
2023,District of Oak Bay,01-0344-00,V8S 2N3,,1256 BEACH,1798000,1787000,286000,2073000
2023,District of Oak Bay,01-0345-00,V8S 2N3,,1252 BEACH,1835000,1822000,306000,2128000
2023,District of Oak Bay,01-0346-00,V6K 1W4,,1250 BEACH,2438000,1855000,967000,2822000
2023,District of Oak Bay,01-0347-00,V8S 2N3,,1244 BEACH,2366000,1887000,882000,2769000
2023,District of Oak Bay,01-0348-00,V8S 2N3,,1234 BEACH,1715000,1640000,212000,1852000
2023,District of Oak Bay,01-0349-00,V8S 2N3,,1224 BEACH,1775000,1636000,270000,1906000
2023,District of Oak Bay,01-0351-00,V8S 2N3,,1210 BEACH,1996000,1535000,600000,2135000
2023,District of Oak Bay,01-0352-00,V8S 2N3,,1206 BEACH,1727000,1535000,330000,1865000
2023,District of Oak Bay,01-0353-01,V8S 3A7,,2680 MARGATE,1702000,1014000,825000,1839000
2023,District of Oak Bay,01-0353-02,V8S 3A7,,2670 MARGATE,1656000,1014000,777000,1791000
2023,District of Oak Bay,01-0355-00,V8S 5G6,,1021 DEAL,1866000,1488000,534000,2022000
2023,District of Oak Bay,01-0357-05,V8S 5G6,,1023 DEAL,1470000,1214000,380000,1594000
2023,District of Oak Bay,01-0357-05,V8S 5G6,,1023 DEAL,1470000,1214000,380000,1594000
2023,District of Oak Bay,01-0357-10,V8S 5G6,,1027 DEAL,1438000,1282000,267000,1549000
2023,District of Oak Bay,01-0358-00,V8S 5G6,,1039 DEAL,1334000,1282000,156000,1438000
2023,District of Oak Bay,01-0359-00,V8S 5G6,,1045 DEAL,1305000,1282000,118000,1400000
2023,District of Oak Bay,01-0360-00,V8S 5G6,,1051 DEAL,1204200,1282000,10000,1292000
2023,District of Oak Bay,01-0361-00,V6N 3R1,,1059 DEAL,1407000,1281000,237000,1518000
2023,District of Oak Bay,01-0362-00,V8S 5G6,,1063 DEAL,1270000,1097000,263000,1360000
2023,District of Oak Bay,01-0363-00,V8S 5G6,,1065 DEAL,1391000,1097000,398000,1495000
2023,District of Oak Bay,01-0365-00,V8S 5G6,,1073 DEAL,1405000,1096000,423000,1519000
2023,District of Oak Bay,01-0366-00,V8S 5G6,,1079 DEAL,1474000,1281000,318000,1599000
2023,District of Oak Bay,01-0369-00,V8S 2N4,,1247 BEACH,1334000,1120000,133000,1253000
2023,District of Oak Bay,01-0370-02,V8Z 3P7,,1237 BEACH,3233000,2297000,756000,3053000
2023,District of Oak Bay,01-0370-03,V8Z 3P7,,1231 BEACH,4872000,2498000,2388000,4886000
2023,District of Oak Bay,01-0372-00,V8S 2N4,,1227 BEACH,3665000,2603000,915000,3518000
2023,District of Oak Bay,01-0373-00,V8S 2N4,,1221 BEACH,2691000,2084000,469000,2553000
2023,District of Oak Bay,01-0374-01,V8R 1G2,, SATELLITE,8800,10200,0,10200
2023,District of Oak Bay,01-0375-01,V8R 1G2,, SATELLITE,164000,189000,0,189000
2023,District of Oak Bay,01-0377-00,V8P 2L5,,2768 SATELLITE,7664000,5035000,3406000,8441000
2023,District of Oak Bay,01-0377-00,V8P 2L5,,2768 SATELLITE,7664000,5035000,3406000,8441000
2023,District of Oak Bay,01-0377-01,V8R 1G2,, BEACH,177000,204000,0,204000
2023,District of Oak Bay,01-0378-00,V8R 1G2,, MARGATE,614000,718000,0,718000
2023,District of Oak Bay,01-0379-00,V8R 1G2,, MARGATE,1005000,1162000,0,1162000
2023,District of Oak Bay,01-0380-00,V8R 1G2,, MARGATE,261000,301000,0,301000
2023,District of Oak Bay,01-0384-01,V8S 3A6,,2631 MARGATE,2272000,1185000,1388000,2573000
2023,District of Oak Bay,01-0384-02,V8S 3A6,,2635 MARGATE,1243000,952000,395000,1347000
2023,District of Oak Bay,01-0384-02,V8S 4K9,,2635 MARGATE,1243000,952000,395000,1347000
2023,District of Oak Bay,01-0386-00,V8S 3A6,,2623 MARGATE,1552000,1380000,319000,1699000
2023,District of Oak Bay,01-0386-00,V8S 3A6,,2623 MARGATE,1552000,1380000,319000,1699000
2023,District of Oak Bay,01-0386-00,V8S 3A6,,2623 MARGATE,1552000,1380000,319000,1699000
2023,District of Oak Bay,01-0387-00,V8S 5H8,,999 NEWPORT,1641000,1295000,507000,1802000
2023,District of Oak Bay,01-0391-00,V9C 3A6,,2409 CURRIE,1139900,1152000,67600,1219600
2023,District of Oak Bay,01-0392-00,V8R 1G2,, CURRIE,224000,258000,0,258000
2023,District of Oak Bay,01-0393-00,V8R 1G2,, BEACH,1321000,1536000,0,1536000
2023,District of Oak Bay,01-0394-00,V8R 1G2,,1327 BEACH,1781000,2051000,17600,2068600
2023,District of Oak Bay,01-0394-02,V8R 1G2,,1327 BEACH,4651000,3876000,873000,4749000
2023,District of Oak Bay,01-0394-02,V8R 1G2,,1327 BEACH,4651000,3876000,873000,4749000
2023,District of Oak Bay,01-0394-02,V8S 2N4,,1327 BEACH,4651000,3876000,873000,4749000
2023,District of Oak Bay,01-0394-02,V8S 2N4,,1327 BEACH,4651000,3876000,873000,4749000
2023,District of Oak Bay,01-0394-03,V8S 2N4,,1327 BEACH,11034000,10557000,943000,11500000
2023,District of Oak Bay,01-0394-03,V8S 2N4,,1327 BEACH,11034000,10557000,943000,11500000
2023,District of Oak Bay,01-0394-03,V9T 6J9,,1327 BEACH,11034000,10557000,943000,11500000
2023,District of Oak Bay,01-0394-03,V9T 6J9,,1327 BEACH,11034000,10557000,943000,11500000
2023,District of Oak Bay,01-0394-03,V8R 1G2,,1327 BEACH,11034000,10557000,943000,11500000
2023,District of Oak Bay,01-0394-03,V8R 1G2,,1327 BEACH,11034000,10557000,943000,11500000
2023,District of Oak Bay,01-0395-00,V8R 1G2,,1327 BEACH,215600,232000,2300,234300
2023,District of Oak Bay,01-0396-00,V8R 1G2,, BEACH,958000,1107000,0,1107000
2023,District of Oak Bay,01-0397-00,V8R 1G2,, BEACH,218000,251000,0,251000
2023,District of Oak Bay,01-0398-00,V8R 1G2,, NEWPORT,813000,940000,0,940000
2023,District of Oak Bay,01-0399-00,V8R 1G2,,2451 WINDSOR,2469000,2847000,0,2847000
2023,District of Oak Bay,01-0400-00,V8R 1G2,, WINDSOR,3486000,4022000,0,4022000
2023,District of Oak Bay,01-0401-00,V8R 1G2,, WINDSOR,4311000,4258000,683000,4941000
2023,District of Oak Bay,01-0402-00,V8R 1G2,, WINDSOR,797000,918000,0,918000
2023,District of Oak Bay,01-0403-00,V8R 1G2,, WINDSOR,797000,918000,0,918000
2023,District of Oak Bay,02-0404-01,V6J 4X9,,1266 NEWPORT,4977000,1727000,3744000,5471000
2023,District of Oak Bay,02-0405-01,V8S 5A5,,1307 TRANSIT,1518000,1298000,385000,1683000
2023,District of Oak Bay,02-0405-02,V8S 5A5,,1327 TRANSIT,1848000,1267000,750000,2017000
2023,District of Oak Bay,02-0406-00,V8L 1K9,,1210 NEWPORT,3193000,2591000,1225000,3816000
2023,District of Oak Bay,02-0407-00,V8S 4Z2,,1321 ST. DAVID,2027000,1872000,305000,2177000
2023,District of Oak Bay,02-0408-00,V8S 5A3,,1318 TRANSIT,3312000,2667000,916000,3583000
2023,District of Oak Bay,02-0412-00,V8S 4Z2,,1397 ST. DAVID,2113000,1668000,649000,2317000
2023,District of Oak Bay,02-0415-00,V8S 4X2,,1446 OLIVER,1390000,1315000,177000,1492000
2023,District of Oak Bay,02-0416-00,V8S 4X2,,1428 OLIVER,2454000,1315000,1456000,2771000
2023,District of Oak Bay,02-0417-00,V8S 4X2,,1412 OLIVER,1711000,1380000,478000,1858000
2023,District of Oak Bay,02-0418-00,V8S 4X2,,1398 OLIVER,1464000,1381000,191000,1572000
2023,District of Oak Bay,02-0419-00,V8S 4X2,,1386 OLIVER,1672000,1381000,413000,1794000
2023,District of Oak Bay,02-0422-00,V8S 2G2,,2280 BRIGHTON,1362000,1280000,188000,1468000
2023,District of Oak Bay,02-0423-00,V8S 4V9,,1329 MONTEREY,1288000,1210000,187000,1397000
2023,District of Oak Bay,02-0423-00,V8S 4V9,,1329 MONTEREY,1288000,1210000,187000,1397000
2023,District of Oak Bay,02-0424-00,V8S 4V9,,1345 MONTEREY,1368000,1210000,269000,1479000
2023,District of Oak Bay,02-0424-00,V8S 4V9,,1345 MONTEREY,1368000,1210000,269000,1479000
2023,District of Oak Bay,02-0425-00,V8S 4V9,,1393 MONTEREY,1709000,1304000,544000,1848000
2023,District of Oak Bay,02-0426-00,V8S 4V9,,1401 MONTEREY,1728000,1366000,491000,1857000
2023,District of Oak Bay,02-0426-00,V8S 4V9,,1401 MONTEREY,1728000,1366000,491000,1857000
2023,District of Oak Bay,02-0427-00,V8S 4V9,,1415 MONTEREY,1505000,1236000,394000,1630000
2023,District of Oak Bay,02-0428-00,V8R 1G2,,1429 MONTEREY,615200,708000,10500,718500
2023,District of Oak Bay,02-0433-00,V8R 1H3,,2247 OAK BAY,6617000,1997000,4759000,6756000
2023,District of Oak Bay,02-0433-00,V8V 3K2,,2247 OAK BAY,6617000,1997000,4759000,6756000
2023,District of Oak Bay,02-0434-00,V8S 3E6,,2347 WINDSOR,1409000,1304000,233000,1537000
2023,District of Oak Bay,02-0434-00,V8S 3E6,,2347 WINDSOR,1409000,1304000,233000,1537000
2023,District of Oak Bay,02-0435-00,V8S 4Y2,,1081 ST. PATRICK,2316000,1396000,1126000,2522000
2023,District of Oak Bay,02-0436-00,V8S 3E6,,2353 WINDSOR,1485000,1323000,279000,1602000
2023,District of Oak Bay,02-0437-00,V8S 4Y8,,1084 ST. DAVID,1361000,1323000,159000,1482000
2023,District of Oak Bay,02-0438-00,V8S 4Y8,,1070 ST. DAVID,1390000,1401000,106000,1507000
2023,District of Oak Bay,02-0439-00,V4A 1V7,,1071 ST. PATRICK,1296000,1388000,1000,1389000
2023,District of Oak Bay,02-0440-00,V8S 5C1,,2302 WINDSOR,2522000,1323000,1746000,3069000
2023,District of Oak Bay,02-0441-00,V8R 3K5,,2314 WINDSOR,1250000,1322000,900000,2222000
2023,District of Oak Bay,02-0442-10,V8S 3E3,,2320 WINDSOR,2291000,1723000,812000,2535000
2023,District of Oak Bay,02-0443-00,V8S 4Y4,,1148 ST. PATRICK,1793000,1415000,537000,1952000
2023,District of Oak Bay,02-0444-00,V8S 4X1,,1149 OLIVER,1500000,1415000,193000,1608000
2023,District of Oak Bay,02-0445-00,V8S 4X1,,1165 OLIVER,1879000,1508000,571000,2079000
2023,District of Oak Bay,02-0446-00,V8S 4X1,,1183 OLIVER,1629000,1508000,239000,1747000
2023,District of Oak Bay,02-0447-00,V8S 4Y4,,1182 ST. PATRICK,1899000,1570000,514000,2084000
2023,District of Oak Bay,02-0448-00,V8S 4Y4,,1164 ST. PATRICK,1500000,1445000,166000,1611000
2023,District of Oak Bay,02-0451-00,V8S 4H9,,1001 FOUL BAY,1535000,1274000,377000,1651000
2023,District of Oak Bay,02-0452-00,V8S 4P8,,1330 MITCHELL,1573000,1351000,354000,1705000
2023,District of Oak Bay,02-0453-00,V8S 4H9,,977 FOUL BAY,1395000,1265000,257000,1522000
2023,District of Oak Bay,02-0454-00,V8S 4P8,,1334 MITCHELL,1103000,1015000,203000,1218000
2023,District of Oak Bay,02-0455-00,V8S 4P8,,1346 MITCHELL,1004600,1015000,69300,1084300
2023,District of Oak Bay,02-0459-00,V8S 2E6,,2076 BRIGHTON,1454000,1370000,193000,1563000
2023,District of Oak Bay,02-0460-00,V8S 4P9,,1333 MITCHELL,1293800,1301000,87900,1388900
2023,District of Oak Bay,02-0467-00,V8S 3G5,,2099 GRANITE,1615000,1368000,362000,1730000
2023,District of Oak Bay,02-0468-00,V8S 4P5,,1388 VICTORIA,1424000,1294000,245000,1539000
2023,District of Oak Bay,02-0469-00,V8S 4P5,,1372 VICTORIA,1560000,1337000,364000,1701000
2023,District of Oak Bay,02-0470-00,V8S 4P5,,0 VICTORIA,67400,71800,0,71800
2023,District of Oak Bay,02-0471-00,V8S 4P5,,1358 VICTORIA,1567000,1239000,476000,1715000
2023,District of Oak Bay,02-0472-00,V8S 4P5,,1344 VICTORIA,2534000,2115000,653000,2768000
2023,District of Oak Bay,02-0472-00,V8S 4P5,,1344 VICTORIA,2534000,2115000,653000,2768000
2023,District of Oak Bay,02-0473-00,V8S 4P5,,1312 VICTORIA,1858000,1363000,650000,2013000
2023,District of Oak Bay,02-0474-00,V8S 2E6,,2100 BRIGHTON,1694000,1420000,422000,1842000
2023,District of Oak Bay,02-0480-00,V8W 1G2,,2571 CADBORO BAY,2841000,2570000,332000,2902000
2023,District of Oak Bay,02-0480-00,V8W 1G2,,2571 CADBORO BAY,2841000,2570000,332000,2902000
2023,District of Oak Bay,02-0482-00,V8R 2S4,,2325 ESTEVAN,1762000,1462000,463000,1925000
2023,District of Oak Bay,02-0483-00,V8R 2S4,,2335 ESTEVAN,1938000,1493000,719000,2212000
2023,District of Oak Bay,02-0484-00,V8R 2S4,,2345 ESTEVAN,1571000,1438000,297000,1735000
2023,District of Oak Bay,02-0485-00,V8R 2S4,,2355 ESTEVAN,1615000,1380000,400000,1780000
2023,District of Oak Bay,02-0486-00,V8N 4T7,,2367 ESTEVAN,1288400,1318000,93000,1411000
2023,District of Oak Bay,02-0487-00,V8R 2S4,,2377 ESTEVAN,1643000,1250000,581000,1831000
2023,District of Oak Bay,02-0489-00,V8R 2S4,,2407 ESTEVAN,1334000,1268000,217000,1485000
2023,District of Oak Bay,02-0490-00,V8R 2S4,,2417 ESTEVAN,1168000,905000,363000,1268000
2023,District of Oak Bay,02-0491-00,V8R 5J3,,2609 CADBORO BAY,990000,912000,183000,1095000
2023,District of Oak Bay,02-0492-00,V8R 5J3,,2617 CADBORO BAY,1201000,912000,401000,1313000
2023,District of Oak Bay,02-0493-00,V8R 5J3,,2625 CADBORO BAY,997000,912000,162000,1074000
2023,District of Oak Bay,02-0494-00,V8R 5J3,,2633 CADBORO BAY,942000,912000,113000,1025000
2023,District of Oak Bay,02-0495-00,V8R 5J3,,2641 CADBORO BAY,1003000,922000,169000,1091000
2023,District of Oak Bay,02-0496-00,V8R 2V6,,2363 PACIFIC,1453000,1365000,217000,1582000
2023,District of Oak Bay,02-0497-00,V8R 2S5,,2326 ESTEVAN,1369000,1307000,192000,1499000
2023,District of Oak Bay,02-0498-00,V8R 2S5,,2336 ESTEVAN,1354000,1326000,169000,1495000
2023,District of Oak Bay,02-0499-00,V8R 3T2,,2346 ESTEVAN,1299000,1358000,70000,1428000
2023,District of Oak Bay,02-0500-00,V8N 3W8,,2358 ESTEVAN,1280500,1347000,54600,1401600
2023,District of Oak Bay,02-0501-00,V8R 2S5,,2370 ESTEVAN,1354000,1336000,80400,1416400
2023,District of Oak Bay,02-0502-00,V8R 2S5,,2378 ESTEVAN,1590000,1323000,421000,1744000
2023,District of Oak Bay,02-0503-00,V8R 2S5,,2386 ESTEVAN,1418000,1313000,244000,1557000
2023,District of Oak Bay,02-0504-00,V8R 2S5,,2396 ESTEVAN,1425000,1302000,273000,1575000
2023,District of Oak Bay,02-0505-00,V8R 2S5,,2404 ESTEVAN,1275900,1288000,120000,1408000
2023,District of Oak Bay,02-0506-00,V8R 2S5,,2412 ESTEVAN,2015000,1371000,929000,2300000
2023,District of Oak Bay,02-0507-00,V8Z 1E8,, MUSGRAVE,480000,562000,0,562000
2023,District of Oak Bay,02-0508-00,V8Z 1E8,, MUSGRAVE,495000,573000,0,573000
2023,District of Oak Bay,02-0509-00,V8R 1G2,, MUSGRAVE,595000,696000,0,696000
2023,District of Oak Bay,02-0510-00,V8R 1G2,, MUSGRAVE,681000,796000,0,796000
2023,District of Oak Bay,02-0511-00,V8R 1G2,, MUSGRAVE,774000,899000,0,899000
2023,District of Oak Bay,02-0512-00,V8R 1G2,, MUSGRAVE,855000,987000,0,987000
2023,District of Oak Bay,02-0513-00,V8R 5Y2,,2380 MUSGRAVE,1650000,1438000,389000,1827000
2023,District of Oak Bay,02-0514-00,V8R 5Y2,,2390 MUSGRAVE,1363000,1322000,166000,1488000
2023,District of Oak Bay,02-0514-00,V8R 5Y2,,2390 MUSGRAVE,1363000,1322000,166000,1488000
2023,District of Oak Bay,02-0515-00,V8R 2S4,,2495 ESTEVAN,1420000,1381000,164000,1545000
2023,District of Oak Bay,02-0515-00,V8R 2S4,,2495 ESTEVAN,1420000,1381000,164000,1545000
2023,District of Oak Bay,02-0515-00,V8R 2S4,,2495 ESTEVAN,1420000,1381000,164000,1545000
2023,District of Oak Bay,02-0516-00,V8R 5Y9,,2541 ESTEVAN,2313000,1133000,1650000,2783000
2023,District of Oak Bay,02-0516-00,V8R 2S6,,2541 ESTEVAN,2313000,1133000,1650000,2783000
2023,District of Oak Bay,02-0517-00,V8R 1G1,,2531 ESTEVAN,1450900,1079000,511000,1590000
2023,District of Oak Bay,02-0518-00,V8R 2S6,,2525 ESTEVAN,1463000,1080000,414000,1494000
2023,District of Oak Bay,02-0519-00,V8V 0G3,,2515 ESTEVAN,2315000,1079000,1574000,2653000
2023,District of Oak Bay,02-0520-00,V8R 1G1,,2509 ESTEVAN,1615000,1133000,705000,1838000
2023,District of Oak Bay,02-0521-00,V8R 5Y1,,2435 MUSGRAVE,1116700,1181000,45200,1226200
2023,District of Oak Bay,02-0522-00,V8R 5Y1,,2425 MUSGRAVE,1318000,1251000,182000,1433000
2023,District of Oak Bay,02-0523-00,V8R 5Y1,,2405 MUSGRAVE,1347000,1251000,217000,1468000
2023,District of Oak Bay,02-0523-00,V8R 5Y1,,2405 MUSGRAVE,1347000,1251000,217000,1468000
2023,District of Oak Bay,02-0524-00,V8R 5Y1,,2397 MUSGRAVE,1285000,1251000,152000,1403000
2023,District of Oak Bay,02-0525-00,V8R 5Y1,,2383 MUSGRAVE,1291000,1251000,159000,1410000
2023,District of Oak Bay,02-0526-00,V8R 5Y1,,2369 MUSGRAVE,1330000,1251000,196000,1447000
2023,District of Oak Bay,02-0527-00,V8R 5Y1,,2355 MUSGRAVE,1275000,1251000,136000,1387000
2023,District of Oak Bay,02-0528-00,V8R 5Y1,,2339 MUSGRAVE,1402000,1251000,272000,1523000
2023,District of Oak Bay,02-0529-00,V8R 5Y1,,2325 MUSGRAVE,1396000,1251000,241000,1492000
2023,District of Oak Bay,02-0530-00,V8R 5Y1,,2311 MUSGRAVE,1256000,1251000,121000,1372000
2023,District of Oak Bay,02-0531-00,V8R 5Y1,,2297 MUSGRAVE,1305000,1251000,173000,1424000
2023,District of Oak Bay,02-0532-00,V8R 5Y1,,2283 MUSGRAVE,1295000,1251000,161000,1412000
2023,District of Oak Bay,02-0533-00,V8R 1G2,, MUSGRAVE,220000,253000,0,253000
2023,District of Oak Bay,02-0534-00,V8R 5Y9,,2310 DUNLEVY,1359100,1390000,100000,1490000
2023,District of Oak Bay,02-0536-00,V8R 5Z2,,2544 DUNLEVY,3797000,2267000,2332000,4599000
2023,District of Oak Bay,02-0537-00,V8V 3K2,,2522 ESTEVAN,1745000,1079000,1017000,2096000
2023,District of Oak Bay,02-0538-00,V8X 3W4,,2518 ESTEVAN,2076000,1079000,1667000,2746000
2023,District of Oak Bay,02-0538-00,V8X 3W4,,2518 ESTEVAN,2076000,1079000,1667000,2746000
2023,District of Oak Bay,02-0539-00,V8W 3G3,,2510 ESTEVAN,1611000,1134000,512000,1646000
2023,District of Oak Bay,02-0540-00,V8R 5Y3,,2547 MUSGRAVE,1335000,1181000,278000,1459000
2023,District of Oak Bay,02-0541-00,V8R 5Y3,,2559 MUSGRAVE,1327000,1293000,171000,1464000
2023,District of Oak Bay,02-0542-00,V8R 5Y3,,2571 MUSGRAVE,1398000,1306000,217000,1523000
2023,District of Oak Bay,02-0543-00,V8R 5Y3,,2583 MUSGRAVE,1341000,1320000,139000,1459000
2023,District of Oak Bay,02-0544-00,V8R 5Y3,,2595 MUSGRAVE,1555000,1320000,392000,1712000
2023,District of Oak Bay,02-0545-00,V8R 5Y3,,2607 MUSGRAVE,1381000,1348000,159000,1507000
2023,District of Oak Bay,02-0546-00,V8R 5Y3,,2621 MUSGRAVE,2236000,1348000,1118000,2466000
2023,District of Oak Bay,02-0547-00,V8R 5Y3,,2635 MUSGRAVE,1637000,1348000,450000,1798000
2023,District of Oak Bay,02-0548-00,V8R 5Y3,,2649 MUSGRAVE,1356000,1348000,151000,1499000
2023,District of Oak Bay,02-0549-00,V8R 5Y3,,2663 MUSGRAVE,1630000,1348000,418000,1766000
2023,District of Oak Bay,02-0550-00,V8R 5Y3,,2677 MUSGRAVE,1426000,1348000,206000,1554000
2023,District of Oak Bay,02-0551-00,V8R 5Z2,,2548 DUNLEVY,1429000,1390000,164000,1554000
2023,District of Oak Bay,02-0552-00,V8R 5Z2,,2560 DUNLEVY,1446000,1390000,187000,1577000
2023,District of Oak Bay,02-0553-00,V8R 5Z2,,2564 DUNLEVY,1430000,1390000,171000,1561000
2023,District of Oak Bay,02-0554-00,V8R 5Z2,,2584 DUNLEVY,1431000,1390000,163000,1553000
2023,District of Oak Bay,02-0555-00,V8R 5Z2,,2596 DUNLEVY,1474000,1390000,227000,1617000
2023,District of Oak Bay,02-0556-00,V8R 5Z2,,2608 DUNLEVY,1300000,1390000,46800,1436800
2023,District of Oak Bay,02-0557-00,V8R 5Z2,,2622 DUNLEVY,1406000,1390000,145000,1535000
2023,District of Oak Bay,02-0558-00,V8R 5Z2,,2636 DUNLEVY,1421000,1390000,156000,1546000
2023,District of Oak Bay,02-0559-00,V8R 5Z2,,2650 DUNLEVY,1396000,1390000,134000,1524000
2023,District of Oak Bay,02-0560-00,,,2664 DUNLEVY,1507000,1390000,255000,1645000
2023,District of Oak Bay,02-0561-00,V8R 5Z2,,2678 DUNLEVY,1433000,1390000,172000,1562000
2023,District of Oak Bay,02-0562-00,V8R 2S8,,2591 ESTEVAN,1349000,1343000,133000,1476000
2023,District of Oak Bay,02-0563-00,V8R 2S8,,2583 ESTEVAN,1380000,1343000,168000,1511000
2023,District of Oak Bay,02-0564-00,V8R 2S8,,2575 ESTEVAN,1356000,1343000,142000,1485000
2023,District of Oak Bay,02-0565-00,V8R 2S8,,2567 ESTEVAN,2600000,2686000,17800,2703800
2023,District of Oak Bay,02-0565-00,V8R 2S8,,2567 ESTEVAN,2600000,2686000,17800,2703800
2023,District of Oak Bay,02-0566-00,V8R 2S8,,2439 DUNLEVY,1317100,1390000,53200,1443200
2023,District of Oak Bay,02-0567-00,V8R 5Z1,,2425 DUNLEVY,1378000,1390000,114000,1504000
2023,District of Oak Bay,02-0568-00,V8R 5Z1,,2405 DUNLEVY,1730000,1623000,251000,1874000
2023,District of Oak Bay,02-0569-00,V8R 5Z1,,2383 DUNLEVY,1612000,1624000,136000,1760000
2023,District of Oak Bay,02-0569-00,V8R 5Z1,,2383 DUNLEVY,1612000,1624000,136000,1760000
2023,District of Oak Bay,02-0570-00,V8R 5Z1,,2369 DUNLEVY,1473000,1391000,197000,1588000
2023,District of Oak Bay,02-0571-00,V8S 4T2,,2355 DUNLEVY,1378000,1390000,114000,1504000
2023,District of Oak Bay,02-0572-00,V8R 5Z1,,2339 DUNLEVY,1422000,1390000,157000,1547000
2023,District of Oak Bay,02-0573-00,V8R 5Z1,,2325 DUNLEVY,2463000,1390000,1451000,2841000
2023,District of Oak Bay,02-0575-00,V8R 5Z6,,2438 HERON,1525000,1389000,267000,1656000
2023,District of Oak Bay,02-0576-00,V8R 5Z6,,2424 HERON,1487000,1389000,224000,1613000
2023,District of Oak Bay,02-0577-00,V8R 5Z6,,2410 HERON,1394000,1389000,131000,1520000
2023,District of Oak Bay,02-0578-00,V8R 5Z6,,2396 HERON,1355500,1389000,92900,1481900
2023,District of Oak Bay,02-0579-00,V8R 5Z6,,2382 HERON,1871000,1621000,442000,2063000
2023,District of Oak Bay,02-0579-00,V8R 5Z6,,2382 HERON,1871000,1621000,442000,2063000
2023,District of Oak Bay,02-0581-00,V8R 2S9,,2592 ESTEVAN,1541000,1343000,360000,1703000
2023,District of Oak Bay,02-0582-00,V8R 2S9,,2584 ESTEVAN,1340000,1343000,121000,1464000
2023,District of Oak Bay,02-0583-00,V8R 2S9,,2576 ESTEVAN,1390000,1343000,183000,1526000
2023,District of Oak Bay,02-0584-00,V8R 2S9,,2568 ESTEVAN,1356000,1343000,142000,1485000
2023,District of Oak Bay,02-0585-00,V8R 2S9,,2560 ESTEVAN,2015000,1343000,905000,2248000
2023,District of Oak Bay,02-0586-00,V8R 5Z3,,2547 DUNLEVY,1603000,1390000,376000,1766000
2023,District of Oak Bay,02-0587-00,V8R 5Z3,,2559 DUNLEVY,1884000,1390000,686000,2076000
2023,District of Oak Bay,02-0588-00,V8R 6L3,,2571 DUNLEVY,1787000,1622000,321000,1943000
2023,District of Oak Bay,02-0588-00,V8R 5Z3,,2571 DUNLEVY,1787000,1622000,321000,1943000
2023,District of Oak Bay,02-0590-00,V8R 5Z3,,2595 DUNLEVY,1657000,1623000,194000,1817000
2023,District of Oak Bay,02-0591-00,V8R 5Z8,,2544 HERON,1548000,1490000,200000,1690000
2023,District of Oak Bay,02-0593-00,V8R 1G2,,2564 HERON,1956900,2060000,95600,2155600
2023,District of Oak Bay,02-0593-00,V8R 1G2,,2564 HERON,1956900,2060000,95600,2155600
2023,District of Oak Bay,02-0594-00,V8R 6S4,,2594 HERON,1465000,1390000,202000,1592000
2023,District of Oak Bay,02-0595-00,V8R 6A2,,2706 HERON,1418000,1390000,163000,1553000
2023,District of Oak Bay,02-0596-00,V8R 6A2,,2720 HERON,1796000,1390000,629000,2019000
2023,District of Oak Bay,02-0597-00,V8R 6A2,,2734 HERON,1396000,1390000,133000,1523000
2023,District of Oak Bay,02-0599-01,V8R 6A2,,2742 HERON,1560000,1390000,301000,1691000
2023,District of Oak Bay,02-0599-01,V8R 6A2,,2742 HERON,1560000,1390000,301000,1691000
2023,District of Oak Bay,02-0599-02,V8R 6A2,,2752 HERON,1750000,1517000,399000,1916000
2023,District of Oak Bay,02-0600-00,V8R 2T3,,2641 ESTEVAN,1315900,1358000,86500,1444500
2023,District of Oak Bay,02-0601-00,V8R 2T1,,2633 ESTEVAN,1526000,1358000,314000,1672000
2023,District of Oak Bay,02-0602-00,V8R 2T1,,2625 ESTEVAN,1435000,1358000,215000,1573000
2023,District of Oak Bay,02-0603-00,V8R 2T1,,2617 ESTEVAN,1493000,1358000,272000,1630000
2023,District of Oak Bay,02-0604-00,V8R 2T1,,2609 ESTEVAN,1393000,1358000,170000,1528000
2023,District of Oak Bay,02-0605-00,V8R 5Z7,,2439 HERON,1348700,1385000,101000,1486000
2023,District of Oak Bay,02-0606-00,V8R 5Z7,,2425 HERON,1373000,1390000,110000,1500000
2023,District of Oak Bay,02-0607-00,V8R 5Z7,,2411 HERON,1384000,1389000,121000,1510000
2023,District of Oak Bay,02-0608-00,V8R 5Z7,,2397 HERON,1372000,1389000,110000,1499000
2023,District of Oak Bay,02-0609-00,V8N 2L3,,2383 HERON,1584000,1622000,330000,1952000
2023,District of Oak Bay,02-0611-00,V8R 6A4,,2438 LINCOLN,1466000,1390000,200000,1590000
2023,District of Oak Bay,02-0612-00,V8R 6A4,,2424 LINCOLN,1700000,1390000,501000,1891000
2023,District of Oak Bay,02-0613-00,V8R 6A4,,2410 LINCOLN,1411000,1389000,151000,1540000
2023,District of Oak Bay,02-0614-00,V8R 6A4,,2396 LINCOLN,1349400,1389000,88200,1477200
2023,District of Oak Bay,02-0615-00,V8R 2T2,,2640 ESTEVAN,1786000,1358000,628000,1986000
2023,District of Oak Bay,02-0616-00,V8R 2T2,,2632 ESTEVAN,1583000,1358000,392000,1750000
2023,District of Oak Bay,02-0617-00,V8R 2T2,,2624 ESTEVAN,1429000,1357000,201000,1558000
2023,District of Oak Bay,02-0618-00,V8R 2T2,,2616 ESTEVAN,1888000,1357000,751000,2108000
2023,District of Oak Bay,02-0618-00,V8R 2T2,,2616 ESTEVAN,1888000,1357000,751000,2108000
2023,District of Oak Bay,02-0619-00,V8R 2T2,,2608 ESTEVAN,1717000,1357000,532000,1889000
2023,District of Oak Bay,02-0620-00,V6P 6R2,,2547 HERON,1569000,1391000,318000,1709000
2023,District of Oak Bay,02-0621-00,V8R 5Z9,,2563 HERON,1399000,1391000,135000,1526000
2023,District of Oak Bay,02-0622-00,V8R 5Z9,,2571 HERON,1451000,1391000,184000,1575000
2023,District of Oak Bay,02-0623-00,V8R 5Z9,,2583 HERON,1551000,1391000,254000,1645000
2023,District of Oak Bay,02-0624-00,V8R 5Z9,,2595 HERON,1435000,1391000,175000,1566000
2023,District of Oak Bay,02-0625-00,V8R 5Z9,,2609 HERON,1361200,1391000,110000,1501000
2023,District of Oak Bay,02-0626-01,V8R 5Z9,,2627 HERON,1717000,1391000,496000,1887000
2023,District of Oak Bay,02-0626-02,V8R 5Z9,,2637 HERON,2053000,1391000,834000,2225000
2023,District of Oak Bay,02-0627-00,V8R 6A6,,2548 LINCOLN,1444000,1432000,146000,1578000
2023,District of Oak Bay,02-0628-00,V8R 6A6,,2560 LINCOLN,1606000,1432000,327000,1759000
2023,District of Oak Bay,02-0629-00,B3H 2X3,,2572 LINCOLN,1454000,1432000,155000,1587000
2023,District of Oak Bay,02-0630-00,V8R 6A6,,2584 LINCOLN,2458000,1432000,1317000,2749000
2023,District of Oak Bay,02-0631-00,V8R 6A6,,2596 LINCOLN,1424000,1432000,117000,1549000
2023,District of Oak Bay,02-0632-00,V8R 6A6,,2608 LINCOLN,1589000,1432000,320000,1752000
2023,District of Oak Bay,02-0633-00,V8R 6A6,,2620 LINCOLN,2183000,1433000,958000,2391000
2023,District of Oak Bay,02-0634-00,V8R 6A6,,2636 LINCOLN,1638000,1433000,369000,1802000
2023,District of Oak Bay,02-0635-00,V8R 6A6,,2650 LINCOLN,1409600,1433000,104000,1537000
2023,District of Oak Bay,02-0636-00,V8R 6A6,,2664 LINCOLN,1706000,1433000,424000,1857000
2023,District of Oak Bay,02-0637-00,V8R 6A6,,2678 LINCOLN,1457000,1433000,157000,1590000
2023,District of Oak Bay,02-0638-00,V8R 6A7,,2714 LINCOLN,3837000,1922000,2428000,4350000
2023,District of Oak Bay,02-0639-00,V8R 6K1,,2470 BEACH,1814000,1372000,643000,2015000
2023,District of Oak Bay,02-0639-01,V8R 2T3,,2685 ESTEVAN,1671000,1372000,488000,1860000
2023,District of Oak Bay,02-0640-00,V8R 2T3,,2677 ESTEVAN,1411000,1372000,161000,1533000
2023,District of Oak Bay,02-0641-00,V8R 2T3,,2669 ESTEVAN,1371000,1372000,129000,1501000
2023,District of Oak Bay,02-0642-00,V8R 2T3,,2661 ESTEVAN,1310500,1372000,67800,1439800
2023,District of Oak Bay,02-0643-00,V8R 6A3,,2439 LINCOLN,1348400,1391000,89100,1480100
2023,District of Oak Bay,02-0644-00,V8R 6A3,,2425 LINCOLN,1316700,1391000,54400,1445400
2023,District of Oak Bay,02-0645-00,V8R 6A3,,2411 LINCOLN,1408000,1391000,168000,1559000
2023,District of Oak Bay,02-0646-00,V8R 6A3,,2397 LINCOLN,1579000,1391000,319000,1710000
2023,District of Oak Bay,02-0647-00,V8R 6A3,,2383 LINCOLN,1713000,1697000,173000,1870000
2023,District of Oak Bay,02-0648-00,V8R 6K1,,2440 BEACH,1344600,1391000,83300,1474300
2023,District of Oak Bay,02-0649-00,V8R 6K1,,2424 BEACH,1585000,1391000,392000,1783000
2023,District of Oak Bay,02-0650-00,V8R 6K1,,2406 BEACH,1444000,1391000,185000,1576000
2023,District of Oak Bay,02-0651-00,V8R 6K1,,2392 BEACH,1464000,1391000,217000,1608000
2023,District of Oak Bay,02-0652-00,,,2376 BEACH,1409000,1392000,154000,1546000
2023,District of Oak Bay,02-0653-00,V8R 6K1,,2358 BEACH,1887000,1392000,703000,2095000
2023,District of Oak Bay,02-0654-00,V8R 6K4,,2516 BEACH,1417000,1414000,149000,1563000
2023,District of Oak Bay,02-0654-00,V8R 6K4,,2516 BEACH,1417000,1414000,149000,1563000
2023,District of Oak Bay,02-0655-00,V8N 1L1,,2528 BEACH,1535000,1457000,231000,1688000
2023,District of Oak Bay,02-0655-00,V8N 1L1,,2528 BEACH,1535000,1457000,231000,1688000
2023,District of Oak Bay,02-0656-00,V8R 2T4,,2676 ESTEVAN,1446000,1372000,206000,1578000
2023,District of Oak Bay,02-0657-00,V8R 2T4,,2668 ESTEVAN,1408000,1372000,167000,1539000
2023,District of Oak Bay,02-0658-00,V8R 2T4,,2660 ESTEVAN,1450000,1372000,214000,1586000
2023,District of Oak Bay,02-0659-00,V8R 6A5,,2547 LINCOLN,1440000,1433000,141000,1574000
2023,District of Oak Bay,02-0660-00,V8R 6A5,,2559 LINCOLN,1409200,1433000,121000,1554000
2023,District of Oak Bay,02-0661-00,V8R 3M1,,2571 LINCOLN,1526000,1433000,241000,1674000
2023,District of Oak Bay,02-0662-00,V8R 6A5,,2583 LINCOLN,1362100,1433000,55100,1488100
2023,District of Oak Bay,02-0663-00,V8R 6A5,,2595 LINCOLN,1430000,1433000,128000,1561000
2023,District of Oak Bay,02-0664-00,V8R 6A5,,2607 LINCOLN,1737000,1433000,490000,1923000
2023,District of Oak Bay,02-0665-00,V8R 6A5,,2621 LINCOLN,2235000,1433000,1035000,2468000
2023,District of Oak Bay,02-0665-00,V8R 6A5,,2621 LINCOLN,2235000,1433000,1035000,2468000
2023,District of Oak Bay,02-0666-00,V8R 6A5,,2635 LINCOLN,2113000,1433000,911000,2344000
2023,District of Oak Bay,02-0667-00,V8R 6A5,,2649 LINCOLN,1422000,1433000,121000,1554000
2023,District of Oak Bay,02-0668-00,V8R 6A5,,2663 LINCOLN,1508000,1434000,222000,1656000
2023,District of Oak Bay,02-0669-00,V8R 6A5,,2677 LINCOLN,2578000,1504000,1455000,2959000
2023,District of Oak Bay,02-0670-00,V8R 6A5,,2697 LINCOLN,2233000,1733000,718000,2451000
2023,District of Oak Bay,02-0671-00,V8R 6K4,,2544 BEACH,1510000,1432000,213000,1645000
2023,District of Oak Bay,02-0672-00,V8R 6K4,,2558 BEACH,1471000,1432000,172000,1604000
2023,District of Oak Bay,02-0673-00,V8R 6K4,,2570 BEACH,1528000,1432000,255000,1687000
2023,District of Oak Bay,02-0674-00,V8R 6K4,,2582 BEACH,1529000,1432000,269000,1701000
2023,District of Oak Bay,02-0675-00,V8R 6K4,,2594 BEACH,1475000,1432000,177000,1609000
2023,District of Oak Bay,02-0676-00,V8R 6K4,,2610 BEACH,1590000,1446000,280000,1726000
2023,District of Oak Bay,02-0677-00,V8R 6K4,,2630 BEACH,1535000,1446000,246000,1692000
2023,District of Oak Bay,02-0678-00,V8R 6K4,,2650 BEACH,1479000,1460000,158000,1618000
2023,District of Oak Bay,02-0679-00,V8R 6K4,,2670 BEACH,1916000,1566000,538000,2104000
2023,District of Oak Bay,02-0680-00,V8R 6K4,,2690 BEACH,2722000,1945000,1021000,2966000
2023,District of Oak Bay,02-0683-00,V8R 2W2,,2452 ESPLANADE,3098000,2326000,1025000,3351000
2023,District of Oak Bay,02-0684-00,V2P 1Z6,,2438 ESPLANADE,2192000,2331000,1000,2332000
2023,District of Oak Bay,02-0685-00,V8R 2W2,,2422 ESPLANADE,3163000,2335000,1223000,3558000
2023,District of Oak Bay,02-0686-00,,,2408 ESPLANADE,2379000,2340000,188000,2528000
2023,District of Oak Bay,02-0686-00,,,2408 ESPLANADE,2379000,2340000,188000,2528000
2023,District of Oak Bay,02-0688-01,V8R 2W2,,2378 ESPLANADE,3405000,2345000,1429000,3774000
2023,District of Oak Bay,02-0688-01,V8R 2W2,,2378 ESPLANADE,3405000,2345000,1429000,3774000
2023,District of Oak Bay,02-0688-02,V0K 1V0,,2391 BEACH,3613000,2005000,1994000,3999000
2023,District of Oak Bay,02-0688-02,V0K 1V0,,2391 BEACH,3613000,2005000,1994000,3999000
2023,District of Oak Bay,02-0688-03,V8R 2W2,,2368 ESPLANADE,2689000,2349000,576000,2925000
2023,District of Oak Bay,02-0688-03,V8R 2W2,,2368 ESPLANADE,2689000,2349000,576000,2925000
2023,District of Oak Bay,02-0689-00,V8V 3K2,,2358 ESPLANADE,5215000,1862000,3874000,5736000
2023,District of Oak Bay,02-0695-00,V8R 6K2,,2487 BEACH,1673000,1539000,293000,1832000
2023,District of Oak Bay,02-0696-00,V8S 3T4,,2471 BEACH,1567000,1538000,175000,1713000
2023,District of Oak Bay,02-0697-00,V8W 2H6,,2455 BEACH,3364000,2850000,855000,3705000
2023,District of Oak Bay,02-0697-00,V8W 2H6,,2455 BEACH,3364000,2850000,855000,3705000
2023,District of Oak Bay,02-0699-00,V8R 6K2,,2423 BEACH,1559000,1539000,164000,1703000
2023,District of Oak Bay,02-0700-00,V8N 4Y9,,2407 BEACH,1569000,1539000,174000,1713000
2023,District of Oak Bay,02-0700-00,V8Z 7K1,,2407 BEACH,1569000,1539000,174000,1713000
2023,District of Oak Bay,02-0702-00,V8V 4Y9,,2359 BEACH,2525000,1480000,1297000,2777000
2023,District of Oak Bay,02-0706-00,V8R 2T6,,2710 ESTEVAN,2303000,2247000,214000,2461000
2023,District of Oak Bay,02-0707-00,V8R 2W3,,2524 ESPLANADE,2829000,2356000,723000,3079000
2023,District of Oak Bay,02-0710-00,V8R 2W3,,2560 ESPLANADE,3448000,2430000,2209000,4639000
2023,District of Oak Bay,02-0711-00,,,2570 ESPLANADE,4101000,2453000,1903000,4356000
2023,District of Oak Bay,02-0712-00,V8R 6T4,,2580 ESPLANADE,3362000,2476000,1107000,3583000
2023,District of Oak Bay,02-0713-00,V8R 2W3,,2590 ESPLANADE,3113000,2500000,777000,3277000
2023,District of Oak Bay,02-0715-00,V8R 6K3,,2515 BEACH,1591000,1539000,203000,1742000
2023,District of Oak Bay,02-0716-00,V8R 6K3,,2527 BEACH,1810000,1586000,392000,1978000
2023,District of Oak Bay,02-0717-00,V8R 6K3,,2535 BEACH,2090000,1585000,776000,2361000
2023,District of Oak Bay,02-0718-00,V8R 6K3,,2545 BEACH,1917000,1585000,553000,2138000
2023,District of Oak Bay,02-0719-00,M8X 2X3,,2565 BEACH,4180000,2850000,2122000,4972000
2023,District of Oak Bay,02-0719-00,M8X 2X3,,2565 BEACH,4180000,2850000,2122000,4972000
2023,District of Oak Bay,02-0721-00,V8W 2H7,,2587 BEACH,3575000,2850000,1086000,3936000
2023,District of Oak Bay,02-0721-00,V8W 2H7,,2587 BEACH,3575000,2850000,1086000,3936000
2023,District of Oak Bay,02-0721-00,V8W 2H7,,2587 BEACH,3575000,2850000,1086000,3936000
2023,District of Oak Bay,02-0721-00,V8W 2H7,,2587 BEACH,3575000,2850000,1086000,3936000
2023,District of Oak Bay,02-0723-10,V8R 6K3,,2623 BEACH,2276000,1539000,980000,2519000
2023,District of Oak Bay,02-0723-20,V8R 6K3,,2633 BEACH,2390000,1601000,1031000,2632000
2023,District of Oak Bay,02-0723-20,V8R 6K3,,2633 BEACH,2390000,1601000,1031000,2632000
2023,District of Oak Bay,02-0726-00,V8R 6C1,,2350 NOTTINGHAM,2097000,1395000,944000,2339000
2023,District of Oak Bay,02-0727-00,V8R 3L6,,2805 DUFFERIN,1586000,1506000,229000,1735000
2023,District of Oak Bay,02-0727-00,V8R 3L6,,2805 DUFFERIN,1586000,1506000,229000,1735000
2023,District of Oak Bay,02-0727-00,M4K 1K8,,2805 DUFFERIN,1586000,1506000,229000,1735000
2023,District of Oak Bay,02-0727-00,M4K 1K8,,2805 DUFFERIN,1586000,1506000,229000,1735000
2023,District of Oak Bay,02-0727-00,V8T 5J3,,2805 DUFFERIN,1586000,1506000,229000,1735000
2023,District of Oak Bay,02-0727-00,V8T 5J3,,2805 DUFFERIN,1586000,1506000,229000,1735000
2023,District of Oak Bay,02-0728-00,V8R 3L6,,2817 DUFFERIN,1428000,1417000,143000,1560000
2023,District of Oak Bay,02-0729-00,V8R 2B6,,2827 DUFFERIN,2674000,1413000,1616000,3029000
2023,District of Oak Bay,02-0730-00,V8R 3L6,,2833 DUFFERIN,1793000,1606000,366000,1972000
2023,District of Oak Bay,02-0731-00,V8R 5K7,,2861 CADBORO BAY,1480000,1109000,522000,1631000
2023,District of Oak Bay,02-0732-00,V8R 5K1,,2821 CADBORO BAY,1085000,1031000,150000,1181000
2023,District of Oak Bay,02-0733-00,V8R 3K6,,2808 THOMPSON,1756000,1556000,311000,1867000
2023,District of Oak Bay,02-0734-00,V8R 3K6,,2800 THOMPSON,1564000,1523000,186000,1709000
2023,District of Oak Bay,02-0736-00,V8R 3M1,,2817 BURDICK,1707000,1649000,223000,1872000
2023,District of Oak Bay,02-0737-00,V8R 3M1,,2833 BURDICK,1809000,1649000,326000,1975000
2023,District of Oak Bay,02-0738-00,V0J 2N0,,2839 BURDICK,1568000,1412000,291000,1703000
2023,District of Oak Bay,02-0738-00,V8R 3M1,,2839 BURDICK,1568000,1412000,291000,1703000
2023,District of Oak Bay,02-0738-00,V8P 4N7,,2839 BURDICK,1568000,1412000,291000,1703000
2023,District of Oak Bay,02-0739-00,V8R 3M1,,2849 BURDICK,1913000,1649000,458000,2107000
2023,District of Oak Bay,02-0739-00,V8R 3M1,,2849 BURDICK,1913000,1649000,458000,2107000
2023,District of Oak Bay,02-0741-01,V8R 6A9,,2995 UPLANDS,2699000,1416000,1579000,2995000
2023,District of Oak Bay,02-0741-02,V8R 3M1,,2859 BURDICK,2355000,1649000,918000,2567000
2023,District of Oak Bay,02-0742-05,V8R 6A9,,2985 UPLANDS,1554000,1344000,347000,1691000
2023,District of Oak Bay,02-0742-10,V8R 3L7,,2864 DUFFERIN,1455000,1414000,171000,1585000
2023,District of Oak Bay,02-0743-00,V8R 3L7,,2856 DUFFERIN,1434000,1414000,151000,1565000
2023,District of Oak Bay,02-0744-00,V8R 3L7,,2848 DUFFERIN,1401000,1414000,134000,1548000
2023,District of Oak Bay,02-0745-00,V8R 3L7,,2840 DUFFERIN,1561000,1413000,312000,1725000
2023,District of Oak Bay,02-0746-01,V8R 3L7,,2828 DUFFERIN,2598000,1413000,1569000,2982000
2023,District of Oak Bay,02-0746-02,V8R 3L7,,2822 DUFFERIN,2619000,1413000,1591000,3004000
2023,District of Oak Bay,02-0747-00,V8R 3L7,,2816 DUFFERIN,1543000,1413000,277000,1690000
2023,District of Oak Bay,02-0749-00,V8R 6C2,,2400 NOTTINGHAM,1524000,1453000,213000,1666000
2023,District of Oak Bay,02-0749-00,V8R 6C2,,2400 NOTTINGHAM,1524000,1453000,213000,1666000
2023,District of Oak Bay,02-0750-00,V8R 5T4,,2801 DEWDNEY,1681000,1491000,341000,1832000
2023,District of Oak Bay,02-0751-00,V8R 3M5,,2809 DEWDNEY,1543000,1412000,275000,1687000
2023,District of Oak Bay,02-0752-00,V8R 3M5,,2817 DEWDNEY,1481000,1412000,215000,1627000
2023,District of Oak Bay,02-0753-00,V8R 3M5,,2825 DEWDNEY,1719000,1412000,461000,1873000
2023,District of Oak Bay,02-0754-00,V8R 3M5,,2833 DEWDNEY,1500000,1412000,231000,1643000
2023,District of Oak Bay,02-0755-00,V8R 3M5,,2841 DEWDNEY,2060000,1412000,1509000,2921000
2023,District of Oak Bay,02-0756-00,V8R 3M5,,2849 DEWDNEY,1758000,1413000,532000,1945000
2023,District of Oak Bay,02-0757-00,V8R 3M5,,2857 DEWDNEY,1510000,1413000,233000,1646000
2023,District of Oak Bay,02-0758-00,V8R 6B2,,3015 UPLANDS,1577000,1420000,306000,1726000
2023,District of Oak Bay,02-0758-00,V8R 6B2,,3015 UPLANDS,1577000,1420000,306000,1726000
2023,District of Oak Bay,02-0759-00,V8R 6B2,,3023 UPLANDS,1484000,1420000,204000,1624000
2023,District of Oak Bay,02-0759-00,V8S 4T4,,3023 UPLANDS,1484000,1420000,204000,1624000
2023,District of Oak Bay,02-0760-01,V8R 6B2,,3003 UPLANDS,2202000,1843000,586000,2429000
2023,District of Oak Bay,02-0761-00,V8R 3M2,,2856 BURDICK,1656000,1417000,403000,1820000
2023,District of Oak Bay,02-0762-00,V8R 3M2,,2848 BURDICK,1472000,1415000,194000,1609000
2023,District of Oak Bay,02-0763-00,V8R 3M2,,2840 BURDICK,1414000,1414000,154000,1568000
2023,District of Oak Bay,02-0764-00,V8R 3M2,,2824 BURDICK,1563100,1651000,87900,1738900
2023,District of Oak Bay,02-0764-00,V8R 2G6,,2824 BURDICK,1563100,1651000,87900,1738900
2023,District of Oak Bay,02-0764-00,V2R 5X7,,2824 BURDICK,1563100,1651000,87900,1738900
2023,District of Oak Bay,02-0765-00,V8R 3M2,,2816 BURDICK,2869000,1650000,1633000,3283000
2023,District of Oak Bay,02-0767-00,V8R 6C5,,2500 NOTTINGHAM,1953000,1984000,165000,2149000
2023,District of Oak Bay,02-0767-00,V8R 6C5,,2500 NOTTINGHAM,1953000,1984000,165000,2149000
2023,District of Oak Bay,02-0768-05,V8R 3M6,,2812 DEWDNEY,1562000,1480000,243000,1723000
2023,District of Oak Bay,02-0768-10,V8R 3M6,,2816 DEWDNEY,1596000,1484000,255000,1739000
2023,District of Oak Bay,02-0769-00,V8R 3M6,,2832 DEWDNEY,1807000,1726000,266000,1992000
2023,District of Oak Bay,02-0769-00,V8R 3M6,,2832 DEWDNEY,1807000,1726000,266000,1992000
2023,District of Oak Bay,02-0770-00,V6P 5V9,,2848 DEWDNEY,1870000,1743000,300000,2043000
2023,District of Oak Bay,02-0770-00,V6P 5V9,,2848 DEWDNEY,1870000,1743000,300000,2043000
2023,District of Oak Bay,02-0770-00,V6K 2Z7,,2848 DEWDNEY,1870000,1743000,300000,2043000
2023,District of Oak Bay,02-0770-00,V6K 2Z7,,2848 DEWDNEY,1870000,1743000,300000,2043000
2023,District of Oak Bay,02-0772-10,V8R 6B3,,3029 UPLANDS,2076000,1707000,654000,2361000
2023,District of Oak Bay,02-0773-00,V8P 5E2,,2659 CADBORO BAY,957000,894000,144000,1038000
2023,District of Oak Bay,02-0774-00,V2K 4T9,,2747 CADBORO BAY,1168000,894000,403000,1297000
2023,District of Oak Bay,02-0775-00,V8R 5J6,,2755 CADBORO BAY,1013000,894000,217000,1111000
2023,District of Oak Bay,02-0776-00,V8R 5J6,,2763 CADBORO BAY,880000,841000,129000,970000
2023,District of Oak Bay,02-0778-00,V8P 5E2,,2773 THOMPSON,1549000,1554000,138000,1692000
2023,District of Oak Bay,02-0778-00,V8P 5E2,,2773 THOMPSON,1549000,1554000,138000,1692000
2023,District of Oak Bay,02-0779-00,V8R 5W4,,2730 TOPP,1446000,1412000,162000,1574000
2023,District of Oak Bay,02-0780-00,V8N 1K7,,2722 TOPP,1408000,1414000,128000,1542000
2023,District of Oak Bay,02-0781-00,V8R 5W4,,2714 TOPP,1462000,1414000,185000,1599000
2023,District of Oak Bay,02-0782-00,V8R 5W4,,2706 TOPP,1537000,1414000,275000,1689000
2023,District of Oak Bay,02-0783-00,V8R 5W4,,2698 TOPP,1454000,1414000,182000,1596000
2023,District of Oak Bay,02-0784-00,V8R 5W4,,2690 TOPP,1430000,1414000,156000,1570000
2023,District of Oak Bay,02-0785-00,V8R 5W4,,2682 TOPP,1447000,1414000,172000,1586000
2023,District of Oak Bay,02-0786-00,V8R 5W4,,2674 TOPP,1410000,1414000,130000,1544000
2023,District of Oak Bay,02-0787-00,V8R 5W4,,2666 TOPP,1452000,1414000,175000,1589000
2023,District of Oak Bay,02-0788-00,V8R 6V7,,2328 PACIFIC,1462000,1414000,182000,1596000
2023,District of Oak Bay,02-0789-00,V8R 2V7,,2370 PACIFIC,1393000,1414000,107000,1521000
2023,District of Oak Bay,02-0790-00,V8R 2V7,,2362 PACIFIC,1418000,1414000,134000,1548000
2023,District of Oak Bay,02-0791-00,V8R 2V7,,2354 PACIFIC,1618000,1413000,352000,1765000
2023,District of Oak Bay,02-0792-00,V8R 5W5,,2665 TOPP,1401000,1414000,117000,1531000
2023,District of Oak Bay,02-0793-00,V8R 5W5,,2675 TOPP,1711000,1414000,442000,1856000
2023,District of Oak Bay,02-0794-00,V8R 5W5,,2683 TOPP,1435000,1414000,157000,1571000
2023,District of Oak Bay,02-0795-00,V8R 5W5,,2691 TOPP,1452000,1414000,174000,1588000
2023,District of Oak Bay,02-0796-00,V8R 5W5,,2695 TOPP,1408000,1412000,126000,1538000
2023,District of Oak Bay,02-0797-00,V8R 1G2,, THOMPSON,307000,359000,0,359000
2023,District of Oak Bay,02-0799-00,V8R 3K9,,2649 THOMPSON,1445000,1361000,223000,1584000
2023,District of Oak Bay,02-0800-00,V8R 3L5,,2553 DUFFERIN,1847000,1846000,165000,2011000
2023,District of Oak Bay,02-0801-00,V8R 3K8,,2784 THOMPSON,1794000,1734000,205000,1939000
2023,District of Oak Bay,02-0802-00,V8R 3K8,,2776 THOMPSON,1500000,1485000,143000,1628000
2023,District of Oak Bay,02-0803-00,V8R 3K8,,2770 THOMPSON,1631000,1486000,298000,1784000
2023,District of Oak Bay,02-0804-00,V8R 3K8,,2760 THOMPSON,1546000,1486000,202000,1688000
2023,District of Oak Bay,02-0805-00,V8R 3L1,,2756 THOMPSON,1555000,1486000,214000,1700000
2023,District of Oak Bay,02-0806-00,V8R 3L1,,2748 THOMPSON,1552000,1484000,217000,1701000
2023,District of Oak Bay,02-0807-00,V8R 3L1,,2740 THOMPSON,1531000,1485000,186000,1671000
2023,District of Oak Bay,02-0808-00,V8R 3L1,,2732 THOMPSON,1489000,1485000,143000,1628000
2023,District of Oak Bay,02-0809-00,V8R 3L1,,2724 THOMPSON,1487000,1485000,139000,1624000
2023,District of Oak Bay,02-0810-00,V8R 3L1,,2716 THOMPSON,1551000,1485000,213000,1698000
2023,District of Oak Bay,02-0811-00,V8S 4G3,,2708 THOMPSON,1615000,1485000,289000,1774000
2023,District of Oak Bay,02-0812-00,V8R 3L1,,2700 THOMPSON,1489000,1485000,142000,1627000
2023,District of Oak Bay,02-0813-00,V8R 3L3,,2584 THOMPSON,1653000,1499000,288000,1787000
2023,District of Oak Bay,02-0815-00,V8R 3L8,,2625 BURDICK,1495000,1412000,239000,1651000
2023,District of Oak Bay,02-0816-00,V8R 3L8,,2645 BURDICK,1433000,1412000,156000,1568000
2023,District of Oak Bay,02-0817-00,V8R 3L8,,2665 BURDICK,1544000,1412000,286000,1698000
2023,District of Oak Bay,02-0818-00,V8R 3L8,,2685 BURDICK,2565000,1413000,1693000,3106000
2023,District of Oak Bay,02-0819-00,V8R 3L8,,2701 BURDICK,1418000,1413000,139000,1552000
2023,District of Oak Bay,02-0820-00,V8R 3L8,,2709 BURDICK,1495000,1413000,227000,1640000
2023,District of Oak Bay,02-0821-00,V8R 3L8,,2721 BURDICK,1529000,1413000,261000,1674000
2023,District of Oak Bay,02-0822-00,V8R 3L8,,2725 BURDICK,1471000,1413000,190000,1603000
2023,District of Oak Bay,02-0823-00,V8R 3L8,,2731 BURDICK,1459000,1414000,181000,1595000
2023,District of Oak Bay,02-0824-00,V8R 3L8,,2785 BURDICK,1461000,1416000,185000,1601000
2023,District of Oak Bay,02-0825-01,V8R 3L8,,2791 BURDICK,1518000,1419000,241000,1660000
2023,District of Oak Bay,02-0825-02,V8R 6C4,,2409 NOTTINGHAM,1559000,1415000,303000,1718000
2023,District of Oak Bay,02-0827-00,V8R 3L4,,2796 DUFFERIN,1679000,1415000,413000,1828000
2023,District of Oak Bay,02-0828-00,V8R 3L4,,2790 DUFFERIN,1528000,1415000,267000,1682000
2023,District of Oak Bay,02-0829-00,V8R 3L4,,2784 DUFFERIN,1471000,1415000,191000,1606000
2023,District of Oak Bay,02-0830-00,V8R 3L4,,2776 DUFFERIN,1469000,1414000,189000,1603000
2023,District of Oak Bay,02-0831-00,V8R 3L4,,2770 DUFFERIN,2704000,1414000,1627000,3041000
2023,District of Oak Bay,02-0832-00,V8R 3L4,,2764 DUFFERIN,1779000,1731000,216000,1947000
2023,District of Oak Bay,02-0833-00,V8R 3L4,,2748 DUFFERIN,1663000,1562000,213000,1775000
2023,District of Oak Bay,02-0834-00,V8R 3L4,,2740 DUFFERIN,1557000,1414000,271000,1685000
2023,District of Oak Bay,02-0835-00,V8R 3L4,,2732 DUFFERIN,1438000,1414000,164000,1578000
2023,District of Oak Bay,02-0836-00,V8W 3G1,,2724 DUFFERIN,1435000,1414000,155000,1569000
2023,District of Oak Bay,02-0837-00,V8R 3L4,,2716 DUFFERIN,1474000,1413000,200000,1613000
2023,District of Oak Bay,02-0838-00,V8R 3L4,,2708 DUFFERIN,1497000,1413000,218000,1631000
2023,District of Oak Bay,02-0839-00,V8W 0A8,,2700 DUFFERIN,1494000,1413000,225000,1638000
2023,District of Oak Bay,02-0840-00,V9A 7G7,,2608 DUFFERIN,1442000,1415000,162000,1577000
2023,District of Oak Bay,02-0841-00,V8R 3L4,,2588 DUFFERIN,1564000,1415000,302000,1717000
2023,District of Oak Bay,02-0842-00,V8V 1Y4,,2568 DUFFERIN,1480000,1503000,117000,1620000
2023,District of Oak Bay,02-0843-00,V8R 3M3,,2685 DEWDNEY,1670000,1518000,306000,1824000
2023,District of Oak Bay,02-0843-00,V8R 3M3,,2685 DEWDNEY,1670000,1518000,306000,1824000
2023,District of Oak Bay,02-0844-00,V8R 3M3,,2731 DEWDNEY,1496000,1413000,217000,1630000
2023,District of Oak Bay,02-0845-00,V8R 3M3,,2741 DEWDNEY,1848000,1414000,598000,2012000
2023,District of Oak Bay,02-0846-00,V8R 3M3,,2771 DEWDNEY,1493000,1413000,226000,1639000
2023,District of Oak Bay,02-0847-00,V9N 8R9,,2777 DEWDNEY,3199000,1650000,2033000,3683000
2023,District of Oak Bay,02-0848-00,V8R 3M3,,2791 DEWDNEY,3329000,1650000,2168000,3818000
2023,District of Oak Bay,02-0849-00,V8R 3M3,,2797 DEWDNEY,1656000,1413000,411000,1824000
2023,District of Oak Bay,02-0850-00,V8R 3L9,,2796 BURDICK,1896000,1769000,314000,2083000
2023,District of Oak Bay,02-0851-00,V8R 3L9,,2784 BURDICK,1569000,1516000,189000,1705000
2023,District of Oak Bay,02-0852-00,V8R 3L9,,2776 BURDICK,1408000,1414000,126000,1540000
2023,District of Oak Bay,02-0853-00,V8R 3L9,,2740 BURDICK,1458000,1414000,183000,1597000
2023,District of Oak Bay,02-0854-00,V8R 3L9,,2732 BURDICK,1507000,1414000,267000,1681000
2023,District of Oak Bay,02-0855-00,V8R 3L9,,2724 BURDICK,1628000,1414000,384000,1798000
2023,District of Oak Bay,02-0856-00,V8R 3M4,,2700 DEWDNEY,1767000,1699000,237000,1936000
2023,District of Oak Bay,02-0857-00,V8R 3M4,,2716 DEWDNEY,1814000,1700000,302000,2002000
2023,District of Oak Bay,02-0858-10,V8R 3M4,,2724 DEWDNEY,2571000,1456000,1445000,2901000
2023,District of Oak Bay,02-0858-20,V8R 3M4,,2732 DEWDNEY,2568000,1456000,1442000,2898000
2023,District of Oak Bay,02-0859-00,V8R 3M4,,2740 DEWDNEY,1838000,1700000,542000,2242000
2023,District of Oak Bay,02-0860-00,V8R 3M4,,2756 DEWDNEY,1690000,1700000,146000,1846000
2023,District of Oak Bay,02-0861-00,V8R 3M4,,2764 DEWDNEY,1518000,1456000,208000,1664000
2023,District of Oak Bay,02-0862-00,V8R 3M4,,2770 DEWDNEY,1460000,1456000,145000,1601000
2023,District of Oak Bay,02-0863-00,V8R 3M4,,2776 DEWDNEY,1654000,1561000,253000,1814000
2023,District of Oak Bay,02-0864-00,V8R 3M4,,2784 DEWDNEY,1501000,1456000,188000,1644000
2023,District of Oak Bay,02-0865-00,V8R 3M4,,2796 DEWDNEY,1879000,1768000,271000,2039000
2023,District of Oak Bay,02-0866-00,V8R 3L2,,2539 THOMPSON,1489000,1512000,109000,1621000
2023,District of Oak Bay,02-0867-00,V8R 3L2,,2547 THOMPSON,1769000,1632000,319000,1951000
2023,District of Oak Bay,02-0868-00,V8R 3L2,,2563 THOMPSON,1674000,1650000,181000,1831000
2023,District of Oak Bay,02-0869-00,V8R 3L2,,2583 THOMPSON,1594000,1592000,144000,1736000
2023,District of Oak Bay,03-0874-00,V8R 5X8,,1584 PROSPECT,2272000,2026000,461000,2487000
2023,District of Oak Bay,03-0875-00,V8R 5X8,,1660 PROSPECT,2478000,2025000,751000,2776000
2023,District of Oak Bay,03-0876-00,V8R 5X8,,1670 PROSPECT,2238000,2022000,439000,2461000
2023,District of Oak Bay,03-0877-00,V8R 5X8,,1680 PROSPECT,2398000,2021000,602000,2623000
2023,District of Oak Bay,03-0878-00,V8R 1P4,,2420 SAN CARLOS,1694000,1514000,354000,1868000
2023,District of Oak Bay,03-0879-01,V8R 1P4,,2430 SAN CARLOS,2054000,1666000,619000,2285000
2023,District of Oak Bay,03-0879-02,V8R 6J1,,1710 BEACH,2019000,1589000,647000,2236000
2023,District of Oak Bay,03-0888-00,V8R 6H8,,1512 BEACH,2771000,2637000,391000,3028000
2023,District of Oak Bay,03-0889-00,V8W 0A8,,1526 BEACH,2501000,2400000,333000,2733000
2023,District of Oak Bay,03-0890-00,V8R 6H8,,1538 BEACH,2281000,2047000,469000,2516000
2023,District of Oak Bay,03-0891-00,V8L 5M2,, BEACH,39100,42800,0,42800
2023,District of Oak Bay,03-0896-00,V8R 6H8,,1590 BEACH,3289000,2915000,678000,3593000
2023,District of Oak Bay,03-0896-00,V8R 6H8,,1590 BEACH,3289000,2915000,678000,3593000
2023,District of Oak Bay,03-0904-00,V8L 5M2,,1535 PROSPECT,1999000,1887000,311000,2198000
2023,District of Oak Bay,03-0905-00,V8R 5X7,,1513 PROSPECT,2157000,2024000,336000,2360000
2023,District of Oak Bay,03-0906-00,V8R 5X7,,1525 PROSPECT,2383000,2081000,539000,2620000
2023,District of Oak Bay,03-0907-00,V8R 1G2,, BEACH,35400,40800,0,40800
2023,District of Oak Bay,03-0908-00,V8R 1G2,, BEACH,35400,40800,0,40800
2023,District of Oak Bay,03-0909-00,V8R 1G2,, BEACH,35400,40800,0,40800
2023,District of Oak Bay,03-0910-00,V8R 1G2,, BEACH,35400,40800,0,40800
2023,District of Oak Bay,03-0911-00,V8R 1G2,, BEACH,47300,54400,0,54400
2023,District of Oak Bay,03-0912-00,V8R 1G2,, BEACH,54300,62600,0,62600
2023,District of Oak Bay,03-0913-00,V8R 1G2,, BEACH,54300,62600,0,62600
2023,District of Oak Bay,03-0914-00,V8R 1G2,, BEACH,49600,57100,0,57100
2023,District of Oak Bay,03-0915-00,V8R 1G2,, BEACH,47300,54400,0,54400
2023,District of Oak Bay,03-0916-00,V8R 1G2,, BEACH,47300,54400,0,54400
2023,District of Oak Bay,03-0917-00,V8R 1G2,, BEACH,47300,54400,0,54400
2023,District of Oak Bay,03-0918-00,V8R 1G2,, BEACH,165000,190000,0,190000
2023,District of Oak Bay,03-0919-00,V8R 1G2,, BEACH,204000,235000,0,235000
2023,District of Oak Bay,03-0920-00,V8R 1G2,,1499 BEACH,416000,484000,0,484000
2023,District of Oak Bay,03-0920-00,V8R 1G2,,1499 BEACH,416000,484000,0,484000
2023,District of Oak Bay,03-0920-00,V8R 1G2,,1499 BEACH,416000,484000,0,484000
2023,District of Oak Bay,03-0920-00,V8R 1G2,,1499 BEACH,416000,484000,0,484000
2023,District of Oak Bay,03-0921-00,V8T 4K5,,2225 DALHOUSIE,1024300,1061000,57100,1118100
2023,District of Oak Bay,03-0922-00,V8R 2H3,,2231 DALHOUSIE,1376000,1062000,465000,1527000
2023,District of Oak Bay,03-0923-00,V8R 2H3,,2239 DALHOUSIE,1051300,1062000,85700,1147700
2023,District of Oak Bay,03-0924-00,V8R 2H3,,2245 DALHOUSIE,1069100,1063000,114000,1177000
2023,District of Oak Bay,03-0925-00,V8R 2H3,,2253 DALHOUSIE,1590000,1063000,672000,1735000
2023,District of Oak Bay,03-0926-00,V8R 2H3,,2259 DALHOUSIE,1046000,1064000,73100,1137100
2023,District of Oak Bay,03-0927-00,V8R 2H3,,2265 DALHOUSIE,1033800,1064000,68000,1132000
2023,District of Oak Bay,03-0928-00,V8R 2H3,,2273 DALHOUSIE,1692000,1064000,835000,1899000
2023,District of Oak Bay,03-0929-00,V8R 2H3,,2279 DALHOUSIE,2237000,1064000,1587000,2651000
2023,District of Oak Bay,03-0930-00,V8R 5H5,,2378 CADBORO BAY,1063000,1017000,138000,1155000
2023,District of Oak Bay,03-0931-00,V8R 5H5,,2368 CADBORO BAY,1036000,996000,131000,1127000
2023,District of Oak Bay,03-0932-00,V8R 5H5,,2358 CADBORO BAY,998800,986000,110000,1096000
2023,District of Oak Bay,03-0933-00,V8R 2E4,,2348 CADBORO BAY,1010000,975000,121000,1096000
2023,District of Oak Bay,03-0935-00,V9T 3M4,,2268 BOWKER,1153000,1136000,116000,1252000
2023,District of Oak Bay,03-0936-00,V8R 2E4,,2250 BOWKER,1084300,1073000,124000,1197000
2023,District of Oak Bay,03-0937-00,X1A 2V7,,2246 BOWKER,1005500,1016000,86000,1102000
2023,District of Oak Bay,03-0938-00,V8R 2E4,,2240 BOWKER,963000,1014000,39000,1053000
2023,District of Oak Bay,03-0939-00,V8R 2E4,,2238 BOWKER,999900,1015000,75200,1090200
2023,District of Oak Bay,03-0940-00,V8R 2E4,,2234 BOWKER,1239000,1015000,344000,1359000
2023,District of Oak Bay,03-0941-00,V8X 5C7,,2230 BOWKER,975800,1015000,44200,1059200
2023,District of Oak Bay,03-0942-00,V8S 2H1,,2226 BOWKER,1072000,1016000,165000,1181000
2023,District of Oak Bay,03-0943-00,V8R 2E4,,2222 BOWKER,993700,1016000,74000,1090000
2023,District of Oak Bay,03-0954-01,V8R 2E2,101,2285 BOWKER,1149000,1011000,181000,1192000
2023,District of Oak Bay,03-0954-02,V8R 2E2,102,2285 BOWKER,944000,855000,126000,981000
2023,District of Oak Bay,03-0954-03,V8X 4C9,,2296 CADBORO BAY,863000,709000,284000,993000
2023,District of Oak Bay,03-0954-04,V8X 4C9,,2290 CADBORO BAY,752000,581000,284000,865000
2023,District of Oak Bay,03-0954-05,V8X 4C9,,2286 CADBORO BAY,536000,441000,176000,617000
2023,District of Oak Bay,03-0954-06,V8X 4C9,,2280 CADBORO BAY,528000,434000,174000,608000
2023,District of Oak Bay,03-0954-07,V8X 4C9,,2276 CADBORO BAY,463000,358000,175000,533000
2023,District of Oak Bay,03-0954-08,V8X 4C9,,2270 CADBORO BAY,550000,452000,181000,633000
2023,District of Oak Bay,03-0954-09,V8R 2E2,,2260 CADBORO BAY,1262000,1108000,198000,1306000
2023,District of Oak Bay,03-0954-10,V8R 2E2,,2266 CADBORO BAY,1211000,1070000,187000,1257000
2023,District of Oak Bay,03-0954-11,V8Z 3B6,,2285 BOWKER,1089000,994000,166000,1160000
2023,District of Oak Bay,03-0954-12,V8R 2E2,,2285 BOWKER,1020000,937000,152000,1089000
2023,District of Oak Bay,03-0954-13,V9B 0T4,,2285 BOWKER,1055000,984000,156000,1140000
2023,District of Oak Bay,03-0954-14,,301,2285 BOWKER,1158000,1060000,172000,1232000
2023,District of Oak Bay,03-0954-15,V8R 2E2,302,2285 BOWKER,1069000,981000,158000,1139000
2023,District of Oak Bay,03-0954-16,V6B 0B6,303,2285 BOWKER,940000,877000,132000,1009000
2023,District of Oak Bay,03-0954-16,V8R 2Z1,303,2285 BOWKER,940000,877000,132000,1009000
2023,District of Oak Bay,03-0954-17,V8R 2E2,304,2285 BOWKER,940000,877000,132000,1009000
2023,District of Oak Bay,03-0954-18,V8R 2E2,305,2285 BOWKER,951000,887000,134000,1021000
2023,District of Oak Bay,03-0954-19,V8R 6L3,306,2285 BOWKER,1019000,946000,145000,1091000
2023,District of Oak Bay,03-0954-19,V8R 2E2,306,2285 BOWKER,1019000,946000,145000,1091000
2023,District of Oak Bay,03-0954-20,V8R 2E2,307,2285 BOWKER,763000,728000,101000,829000
2023,District of Oak Bay,03-0954-21,V8R 2G6,308,2285 BOWKER,950000,887000,133000,1020000
2023,District of Oak Bay,03-0954-22,V8R 2E2,309,2285 BOWKER,745000,710000,98700,808700
2023,District of Oak Bay,03-0954-23,V8R 2E2,310,2285 BOWKER,744000,709000,98500,807500
2023,District of Oak Bay,03-0954-24,S4P 0J4,311,2285 BOWKER,744000,709000,98500,807500
2023,District of Oak Bay,03-0954-25,V8R 2E2,312,2285 BOWKER,1008000,936000,144000,1080000
2023,District of Oak Bay,03-0954-26,V8V 0E1,313,2285 BOWKER,1162000,1056000,176000,1232000
2023,District of Oak Bay,03-0954-27,V8N 0A5,314,2285 BOWKER,1042000,960000,152000,1112000
2023,District of Oak Bay,03-0954-28,V8R 5G9,315,2285 BOWKER,1069000,992000,154000,1146000
2023,District of Oak Bay,03-0954-29,V8R 2E2,401,2285 BOWKER,1158000,1060000,172000,1232000
2023,District of Oak Bay,03-0954-30,V8R 2E2,402,2285 BOWKER,1093000,1007000,158000,1165000
2023,District of Oak Bay,03-0954-31,V8V 2P1,403,2285 BOWKER,961000,899000,132000,1031000
2023,District of Oak Bay,03-0954-32,V8R 2E2,404,2285 BOWKER,961000,899000,132000,1031000
2023,District of Oak Bay,03-0954-33,N0B 2J0,405,2285 BOWKER,972000,909000,134000,1043000
2023,District of Oak Bay,03-0954-34,V8R 2E2,406,2285 BOWKER,1041000,970000,145000,1115000
2023,District of Oak Bay,03-0954-35,V8R 2E2,407,2285 BOWKER,780000,746000,101000,847000
2023,District of Oak Bay,03-0954-36,V8R 2E2,408,2285 BOWKER,971000,910000,133000,1043000
2023,District of Oak Bay,03-0954-37,V8R 5G9,409,2285 BOWKER,769000,737000,98700,835700
2023,District of Oak Bay,03-0954-38,V8R 2E2,410,2285 BOWKER,759000,727000,98500,825500
2023,District of Oak Bay,03-0954-39,V8R 2E2,411,2285 BOWKER,759000,727000,98500,825500
2023,District of Oak Bay,03-0954-40,V8R 2E2,412,2285 BOWKER,1029000,960000,144000,1104000
2023,District of Oak Bay,03-0954-41,V8R 2E2,413,2285 BOWKER,1859000,2065000,264000,2329000
2023,District of Oak Bay,03-0954-42,V8R 2E2,414,2285 BOWKER,1765000,2026000,233000,2259000
2023,District of Oak Bay,03-0954-43,V8M 2B3,PH1,2285 BOWKER,2097000,2267000,303000,2570000
2023,District of Oak Bay,03-0954-44,V8M 2B3,PH2,2285 BOWKER,1696000,1862000,236000,2098000
2023,District of Oak Bay,03-0954-45,T2S 0N7,PH3,2285 BOWKER,1761000,1936000,244000,2180000
2023,District of Oak Bay,03-0954-46,V8R 2E2,PH4,2285 BOWKER,1451000,1640000,190000,1830000
2023,District of Oak Bay,03-0954-47,V8R 2E2,PH5,2285 BOWKER,1528000,1691000,208000,1899000
2023,District of Oak Bay,03-0954-48,V8R 2E2,PH6,2285 BOWKER,1559000,1740000,210000,1950000
2023,District of Oak Bay,03-0954-49,V8R 2E2,PH7,2285 BOWKER,1747000,1942000,240000,2182000
2023,District of Oak Bay,03-0961-00,V8R 5P5,,2251 EASTDOWNE,1257000,865000,540000,1405000
2023,District of Oak Bay,03-0962-00,V8R 1G2,, EASTDOWNE,14900,33600,0,33600
2023,District of Oak Bay,03-0963-00,V8R 5P5,,2259 EASTDOWNE,837000,877000,296000,1173000
2023,District of Oak Bay,03-0964-00,V8R 2E2,,2215 BOWKER,1292000,1118000,278000,1396000
2023,District of Oak Bay,03-0964-00,V8R 2E2,,2215 BOWKER,1292000,1118000,278000,1396000
2023,District of Oak Bay,03-0966-00,V8R 2E4,,2218 BOWKER,957600,980000,62300,1042300
2023,District of Oak Bay,03-0967-00,V8R 5P6,,2305 EASTDOWNE,1206000,1087000,234000,1321000
2023,District of Oak Bay,03-0968-00,V8R 5P6,,2337 EASTDOWNE,1061800,1057000,98200,1155200
2023,District of Oak Bay,03-0969-00,V8R 5P7,,2361 EASTDOWNE,1079000,1108000,64200,1172200
2023,District of Oak Bay,03-0970-00,V8R 5P6,,2393 EASTDOWNE,1230000,1189000,173000,1362000
2023,District of Oak Bay,03-0971-00,V8R 2H3,,2215 DALHOUSIE,1308000,1022000,422000,1444000
2023,District of Oak Bay,03-0972-00,V8R 5P7,,2485 EASTDOWNE,1129000,1082000,144000,1226000
2023,District of Oak Bay,03-0973-00,V8R 5P7,,2481 EASTDOWNE,1067500,1091000,80100,1171100
2023,District of Oak Bay,03-0973-00,V9V 1P8,,2481 EASTDOWNE,1067500,1091000,80100,1171100
2023,District of Oak Bay,03-0974-00,V8R 5P7,,2467 EASTDOWNE,1044800,1077000,57200,1134200
2023,District of Oak Bay,03-0975-00,V8R 5P7,,2453 EASTDOWNE,1025500,1061000,62000,1123000
2023,District of Oak Bay,03-0976-00,V8R 5P7,,2441 EASTDOWNE,993100,1046000,36500,1082500
2023,District of Oak Bay,03-0976-00,V8P 3Z1,,2441 EASTDOWNE,993100,1046000,36500,1082500
2023,District of Oak Bay,03-0977-00,V8R 5P7,,2423 EASTDOWNE,1068000,1030000,134000,1164000
2023,District of Oak Bay,03-0978-00,V8R 5P7,,2405 EASTDOWNE,1222000,939000,665000,1604000
2023,District of Oak Bay,03-0979-00,V8R 5S9,,2440 MOWAT,1037000,991000,132000,1123000
2023,District of Oak Bay,03-0980-00,V8R 5S9,,2430 MOWAT,981100,961000,112000,1073000
2023,District of Oak Bay,03-0981-00,V8R 5S9,,2424 MOWAT,1169000,1115000,158000,1273000
2023,District of Oak Bay,03-0982-00,V8R 5S9,,2416 MOWAT,1085500,1106000,77200,1183200
2023,District of Oak Bay,03-0983-00,V8R 5S9,,2414 MOWAT,967200,965000,97600,1062600
2023,District of Oak Bay,03-0984-00,V8R 5S9,,2408 MOWAT,1096000,965000,219000,1184000
2023,District of Oak Bay,03-0986-00,V8R 5T1,,2431 MOWAT,1016000,976000,152000,1128000
2023,District of Oak Bay,03-0987-00,V8R 5T1,,2425 MOWAT,1026000,964000,150000,1114000
2023,District of Oak Bay,03-0988-00,V8R 5T1,,2421 MOWAT,1035000,976000,148000,1124000
2023,District of Oak Bay,03-0989-00,V8R 5T1,,2417 MOWAT,1038000,976000,171000,1147000
2023,District of Oak Bay,03-0990-00,V8R 5T1,,2413 MOWAT,1976000,976000,1321000,2297000
2023,District of Oak Bay,03-0991-00,V8R 5T1,,2409 MOWAT,987500,976000,108000,1084000
2023,District of Oak Bay,03-0993-00,V8R 5T2,,2434 DRYFE,1013000,973000,121000,1094000
2023,District of Oak Bay,03-0994-00,V8R 5T2,,2424 DRYFE,1206000,973000,353000,1326000
2023,District of Oak Bay,03-0995-00,V8R 5T2,,2420 DRYFE,977300,978000,81500,1059500
2023,District of Oak Bay,03-0996-00,V8R 5T2,,2418 DRYFE,1048000,973000,185000,1158000
2023,District of Oak Bay,03-0997-00,V8R 5T2,,2414 DRYFE,1011000,974000,144000,1118000
2023,District of Oak Bay,03-0998-00,V8R 2H2,,2260 DALHOUSIE,1131000,976000,300000,1276000
2023,District of Oak Bay,03-0999-00,V8R 1G2,,2001 OAK BAY,622000,728000,0,728000
2023,District of Oak Bay,03-1000-00,V8P 1G7,,2005 OAK BAY,1815000,1315000,648000,1963000
2023,District of Oak Bay,03-1000-00,V8P 1G7,,2005 OAK BAY,1815000,1315000,648000,1963000
2023,District of Oak Bay,03-1001-00,V8V 3N6,,2013 OAK BAY,1857000,929000,1116000,2045000
2023,District of Oak Bay,03-1004-00,,,1456 MITCHELL,1426000,1224000,320000,1544000
2023,District of Oak Bay,03-1005-00,V8P 1G7,,1466 MITCHELL,1215000,1157000,171000,1328000
2023,District of Oak Bay,03-1005-00,V6P 4G8,,1466 MITCHELL,1215000,1157000,171000,1328000
2023,District of Oak Bay,03-1005-00,V8Z 5H9,,1466 MITCHELL,1215000,1157000,171000,1328000
2023,District of Oak Bay,03-1006-00,V8V 3N6,,2045 OAK BAY,1212000,1077000,161000,1238000
2023,District of Oak Bay,03-1006-00,V6P 4G8,,2045 OAK BAY,1212000,1077000,161000,1238000
2023,District of Oak Bay,03-1006-00,V8Z 5H9,,2045 OAK BAY,1212000,1077000,161000,1238000
2023,District of Oak Bay,03-1007-00,V8Z 5H9,,2039 OAK BAY,1030100,1025000,7000,1032000
2023,District of Oak Bay,03-1007-00,V8P 1G7,,2039 OAK BAY,1030100,1025000,7000,1032000
2023,District of Oak Bay,03-1007-00,V6P 4G8,,2039 OAK BAY,1030100,1025000,7000,1032000
2023,District of Oak Bay,03-1010-00,V6H 1G7,,2219 OAK BAY,2900000,972000,1989000,2961000
2023,District of Oak Bay,03-1011-00,V8V 3N6,,2223 OAK BAY,2282000,1187000,1365000,2552000
2023,District of Oak Bay,03-1013-00,V8R 1G2,,2167 OAK BAY,3535000,2935000,1045000,3980000
2023,District of Oak Bay,03-1013-00,V8R 1G2,,2167 OAK BAY,3535000,2935000,1045000,3980000
2023,District of Oak Bay,03-1018-00,V8S 4P4,,1391 VICTORIA,1689000,1397000,431000,1828000
2023,District of Oak Bay,03-1018-00,V8S 4P4,,1391 VICTORIA,1689000,1397000,431000,1828000
2023,District of Oak Bay,03-1020-00,V8S 4P4,,1355 VICTORIA,1570000,1545000,163000,1708000
2023,District of Oak Bay,03-1021-00,V8S 4P4,,1345 VICTORIA,3739000,2233000,1846000,4079000
2023,District of Oak Bay,03-1021-00,V8S 4P4,,1345 VICTORIA,3739000,2233000,1846000,4079000
2023,District of Oak Bay,03-1022-00,V8S 4T3,,1318 HAMPSHIRE,1488000,1279000,328000,1607000
2023,District of Oak Bay,03-1022-00,V8S 4T3,,1318 HAMPSHIRE,1488000,1279000,328000,1607000
2023,District of Oak Bay,03-1023-00,V9A 7N6,,1330 HAMPSHIRE,1509000,1226000,384000,1610000
2023,District of Oak Bay,03-1023-00,V9A 7N6,,1330 HAMPSHIRE,1509000,1226000,384000,1610000
2023,District of Oak Bay,03-1023-00,V9A 7N6,,1330 HAMPSHIRE,1509000,1226000,384000,1610000
2023,District of Oak Bay,03-1023-00,V9A 7N6,,1330 HAMPSHIRE,1509000,1226000,384000,1610000
2023,District of Oak Bay,03-1024-00,V8S 4T3,,1346 HAMPSHIRE,2551000,1237000,1672000,2909000
2023,District of Oak Bay,03-1025-00,V8S 4T3,,1358 HAMPSHIRE,1287000,1236000,147000,1383000
2023,District of Oak Bay,03-1026-00,V8S 4T3,,1368 HAMPSHIRE,1834000,1513000,472000,1985000
2023,District of Oak Bay,03-1027-00,V8R 6L9,,2185 GRANITE,2206000,1299000,1186000,2485000
2023,District of Oak Bay,03-1028-00,V8S 3G8,,2175 GRANITE,2167000,1211000,1200000,2411000
2023,District of Oak Bay,03-1029-00,V8S 3G8,,2179 GRANITE,1474000,1419000,168000,1587000
2023,District of Oak Bay,03-1032-00,V8S 3G8,,2155 GRANITE,1362000,1303000,155000,1458000
2023,District of Oak Bay,03-1033-00,V8S 3G8,,2149 GRANITE,1469000,1285000,308000,1593000
2023,District of Oak Bay,03-1034-00,V8S 2E7,,2162 BRIGHTON,1942000,1722000,384000,2106000
2023,District of Oak Bay,03-1035-00,V8S 2E7,,2160 BRIGHTON,2146000,1905000,425000,2330000
2023,District of Oak Bay,03-1038-00,V8S 3G8,,2171 GRANITE,1977000,1604000,533000,2137000
2023,District of Oak Bay,03-1039-00,V8S 3G8,,2173 GRANITE,2342000,1564000,921000,2485000
2023,District of Oak Bay,03-1040-00,V8S 5A7,,1248 ST. DENIS,1989000,1253000,939000,2192000
2023,District of Oak Bay,03-1040-01,V8S 3E8,,2488 WINDSOR,1897000,1253000,828000,2081000
2023,District of Oak Bay,03-1042-00,V8S 3E8,,2480 WINDSOR,1352000,1253000,206000,1459000
2023,District of Oak Bay,03-1043-00,V8S 3E8,,2470 WINDSOR,1349000,1254000,202000,1456000
2023,District of Oak Bay,03-1044-00,V8S 3E8,,2450 WINDSOR,1896000,1634000,407000,2041000
2023,District of Oak Bay,03-1044-00,V8S 3E8,,2450 WINDSOR,1896000,1634000,407000,2041000
2023,District of Oak Bay,03-1045-00,V8S 3E8,,2434 WINDSOR,2314000,1253000,1329000,2582000
2023,District of Oak Bay,03-1046-00,V8S 3E8,,2426 WINDSOR,1885000,1549000,494000,2043000
2023,District of Oak Bay,03-1046-00,V8S 3E8,,2426 WINDSOR,1885000,1549000,494000,2043000
2023,District of Oak Bay,03-1049-00,V8R 1E9,,2150 OAK BAY,1596000,1432000,366000,1798000
2023,District of Oak Bay,03-1051-00,V8N 6B7,,2180 OAK BAY,2398000,1441000,1009000,2450000
2023,District of Oak Bay,03-1055-00,V6S 1G3,,1534 HAMPSHIRE,1390000,1184000,324000,1508000
2023,District of Oak Bay,03-1056-00,V8R 5T5,,1542 HAMPSHIRE,1309000,1209000,222000,1431000
2023,District of Oak Bay,03-1057-00,V8R 5T5,,1550 HAMPSHIRE,1339000,1209000,261000,1470000
2023,District of Oak Bay,03-1059-00,V8R 5T5,,1566 HAMPSHIRE,2823000,1622000,1351000,2973000
2023,District of Oak Bay,03-1059-00,V8R 5T5,,1566 HAMPSHIRE,2823000,1622000,1351000,2973000
2023,District of Oak Bay,03-1060-00,V8R 5T5,,1576 HAMPSHIRE,1483000,1246000,510000,1756000
2023,District of Oak Bay,03-1061-00,V8R 5T5,,1584 HAMPSHIRE,1251000,1246000,115000,1361000
2023,District of Oak Bay,03-1062-00,V8R 5T5,,1592 HAMPSHIRE,1265000,1246000,145000,1391000
2023,District of Oak Bay,03-1063-00,V8R 5T5,,1600 HAMPSHIRE,1200600,1246000,67600,1313600
2023,District of Oak Bay,03-1064-00,V8R 5T5,,1608 HAMPSHIRE,1618000,1246000,532000,1778000
2023,District of Oak Bay,03-1065-00,V8R 5S3,,1605 WILMOT,1569000,1283000,453000,1736000
2023,District of Oak Bay,03-1066-00,V8R 5S3,,1601 WILMOT,1264300,1283000,95000,1378000
2023,District of Oak Bay,03-1067-00,V8R 5S3,,1589 WILMOT,1413000,1283000,266000,1549000
2023,District of Oak Bay,03-1067-00,V9S 1E6,,1589 WILMOT,1413000,1283000,266000,1549000
2023,District of Oak Bay,03-1068-00,V8R 5S3,,1581 WILMOT,1458000,1283000,312000,1595000
2023,District of Oak Bay,03-1069-00,V8R 5S3,,1573 WILMOT,1703000,1283000,577000,1860000
2023,District of Oak Bay,03-1070-00,V8R 5S3,,1565 WILMOT,1428000,1280000,262000,1542000
2023,District of Oak Bay,03-1070-00,V8R 5S3,,1565 WILMOT,1428000,1280000,262000,1542000
2023,District of Oak Bay,03-1071-00,V8R 5S3,,1557 WILMOT,1439000,1283000,293000,1576000
2023,District of Oak Bay,03-1072-01,V8R 5S3,,1549 WILMOT,1556000,1378000,316000,1694000
2023,District of Oak Bay,03-1076-00,V8R 5S4,,1542 WILMOT,1388000,1255000,255000,1510000
2023,District of Oak Bay,03-1076-00,V8R 5S4,,1542 WILMOT,1388000,1255000,255000,1510000
2023,District of Oak Bay,03-1082-00,V8R 5S4,,1568 WILMOT,1401000,1283000,242000,1525000
2023,District of Oak Bay,03-1082-01,V8R 5S4,,1574 WILMOT,1519000,1283000,380000,1663000
2023,District of Oak Bay,03-1083-00,V8R 5S4,,1580 WILMOT,1504000,1282000,360000,1642000
2023,District of Oak Bay,03-1084-00,V8R 5S4,,1590 WILMOT,1642000,1282000,544000,1826000
2023,District of Oak Bay,03-1085-00,V8R 5S4,,1598 WILMOT,1870000,1282000,760000,2042000
2023,District of Oak Bay,03-1086-00,V8R 5S4,,1606 WILMOT,1429000,1282000,277000,1559000
2023,District of Oak Bay,03-1087-00,V8R 5N5,,1645 YALE,1385000,1245000,250000,1495000
2023,District of Oak Bay,03-1088-00,V8R 5N5,,1635 YALE,1257000,1245000,120000,1365000
2023,District of Oak Bay,03-1089-00,V8R 5N5,,1625 YALE,1299000,1245000,164000,1409000
2023,District of Oak Bay,03-1090-00,V8R 5N5,,1615 YALE,1186700,1245000,43600,1288600
2023,District of Oak Bay,03-1090-00,V8V 2P4,,1615 YALE,1186700,1245000,43600,1288600
2023,District of Oak Bay,03-1092-00,T2E 4H1,,1577 YALE,1963000,1246000,992000,2238000
2023,District of Oak Bay,03-1093-00,V8R 5N5,,1567 YALE,1302000,1246000,194000,1440000
2023,District of Oak Bay,03-1094-00,V8R 5N5,,1557 YALE,1896000,1246000,820000,2066000
2023,District of Oak Bay,03-1095-00,V8R 5N5,,1547 YALE,1804000,1184000,829000,2013000
2023,District of Oak Bay,03-1096-00,V8R 2E6,,2360 BOWKER,1620000,1491000,268000,1759000
2023,District of Oak Bay,03-1096-00,V8R 2E6,,2360 BOWKER,1620000,1491000,268000,1759000
2023,District of Oak Bay,03-1097-00,V8R 5V1,,2050 HAMPSHIRE,1585300,1649000,79100,1728100
2023,District of Oak Bay,03-1097-01,V8R 1G2,, HAMPSHIRE,11300,13000,0,13000
2023,District of Oak Bay,03-1098-00,V8R 5V1,,2056 HAMPSHIRE,1720000,1657000,223000,1880000
2023,District of Oak Bay,03-1099-00,V8R 5V1,,2064 HAMPSHIRE,1587000,1444000,273000,1717000
2023,District of Oak Bay,03-1100-00,V8R 2G5,,2509 CAVENDISH,2520000,1650000,1926000,3576000
2023,District of Oak Bay,03-1101-00,V8R 5V2,,2051 HAMPSHIRE,2235000,1656000,791000,2447000
2023,District of Oak Bay,03-1102-00,V8R 2G1,,2420 BOWKER,1563000,1491000,217000,1708000
2023,District of Oak Bay,03-1103-00,V8N 1X6,,2446 BOWKER,1581000,1573000,180000,1753000
2023,District of Oak Bay,03-1104-00,V8R 2G1,,2470 BOWKER,1871000,1661000,381000,2042000
2023,District of Oak Bay,03-1105-00,V8R 2G1,,2474 BOWKER,1705000,1679000,181000,1860000
2023,District of Oak Bay,03-1106-01,V8R 6N3,,2506 BOWKER,840500,863000,94700,957700
2023,District of Oak Bay,03-1106-01,V8R 6N3,,2506 BOWKER,840500,863000,94700,957700
2023,District of Oak Bay,03-1106-01,V8R 6N3,,2506 BOWKER,840500,863000,94700,957700
2023,District of Oak Bay,03-1107-00,V8R 2G1,,2518 BOWKER,1665000,1679000,142000,1821000
2023,District of Oak Bay,03-1108-00,V8R 2G1,,2530 BOWKER,1685000,1696000,139000,1835000
2023,District of Oak Bay,03-1109-00,V8R 2G1,,2542 BOWKER,1733000,1696000,203000,1899000
2023,District of Oak Bay,03-1110-00,V8R 2G1,,2554 BOWKER,1886000,1696000,378000,2074000
2023,District of Oak Bay,03-1111-00,V8R 2G1,,2566 BOWKER,2808000,1696000,1444000,3140000
2023,District of Oak Bay,03-1112-00,V8R 2G1,,2580 BOWKER,2532000,1696000,1113000,2809000
2023,District of Oak Bay,03-1112-00,V8R 2G1,,2580 BOWKER,2532000,1696000,1113000,2809000
2023,District of Oak Bay,03-1113-00,V8R 2G1,,2592 BOWKER,1928000,1696000,416000,2112000
2023,District of Oak Bay,03-1114-00,V8R 2G1,,2606 BOWKER,2145000,1748000,631000,2379000
2023,District of Oak Bay,03-1114-00,V8R 2H8,,2606 BOWKER,2145000,1748000,631000,2379000
2023,District of Oak Bay,03-1115-00,V8R 2G1,,2620 BOWKER,2849000,1748000,1467000,3215000
2023,District of Oak Bay,03-1115-00,V8R 2H8,,2620 BOWKER,2849000,1748000,1467000,3215000
2023,District of Oak Bay,03-1116-00,V8R 2G1,,2636 BOWKER,1881000,1748000,292000,2040000
2023,District of Oak Bay,03-1117-00,V8R 2G1,,2650 BOWKER,2732000,1749000,1282000,3031000
2023,District of Oak Bay,03-1118-00,V8R 6J7,,2001 BEACH,3123000,1747000,1622000,3369000
2023,District of Oak Bay,03-1119-00,V8R 2G3,,2722 BOWKER,1732000,1800000,95400,1895400
2023,District of Oak Bay,03-1120-00,V8R 2G3,,2732 BOWKER,2018000,1800000,402000,2202000
2023,District of Oak Bay,03-1121-00,V8R 6L9,,2744 BOWKER,2835000,1800000,1345000,3145000
2023,District of Oak Bay,03-1122-00,V8R 5H2,,2050 ESPLANADE,2646000,2619000,204000,2823000
2023,District of Oak Bay,03-1123-00,V8R 5H2,,2064 ESPLANADE,4148000,2570000,1985000,4555000
2023,District of Oak Bay,03-1124-00,V8R 5H2,,2072 ESPLANADE,3604000,2431000,1866000,4297000
2023,District of Oak Bay,03-1125-00,V8R 2G7,,2753 CAVENDISH,2290000,1835000,673000,2508000
2023,District of Oak Bay,03-1126-00,V8R 2G7,,2737 CAVENDISH,2059000,1834000,421000,2255000
2023,District of Oak Bay,03-1127-00,V8R 2G7,,2727 CAVENDISH,3683000,1835000,2159000,3994000
2023,District of Oak Bay,03-1128-00,V8R 2G7,,2713 CAVENDISH,2137000,1834000,515000,2349000
2023,District of Oak Bay,03-1129-00,V9S 3G6,,2060 BEACH,1768000,1748000,187000,1935000
2023,District of Oak Bay,03-1130-00,V8R 6J6,,2064 BEACH,1918000,1748000,344000,2092000
2023,District of Oak Bay,03-1131-00,V8R 1G1,,2667 CAVENDISH,2901000,1749000,1546000,3295000
2023,District of Oak Bay,03-1132-00,V8R 2G5,,2657 CAVENDISH,2190000,1748000,653000,2401000
2023,District of Oak Bay,03-1133-00,V8R 2G5,,2643 CAVENDISH,2191000,1748000,606000,2354000
2023,District of Oak Bay,03-1134-00,V8R 2G5,,2631 CAVENDISH,1894000,1650000,417000,2067000
2023,District of Oak Bay,03-1135-00,V8R 2G5,,2619 CAVENDISH,2036000,1841000,387000,2228000
2023,District of Oak Bay,03-1136-00,V8R 2G5,,2607 CAVENDISH,1787000,1749000,192000,1941000
2023,District of Oak Bay,03-1137-00,V8R 2G5,,2595 CAVENDISH,1753000,1748000,167000,1915000
2023,District of Oak Bay,03-1138-00,V8R 2G5,,2585 CAVENDISH,1839000,1749000,247000,1996000
2023,District of Oak Bay,03-1139-00,V8R 2G5,,2573 CAVENDISH,1990000,1749000,406000,2155000
2023,District of Oak Bay,03-1140-00,V8R 2G5,,2561 CAVENDISH,1825000,1749000,247000,1996000
2023,District of Oak Bay,03-1141-00,V8R 2G5,,2549 CAVENDISH,1950000,1661000,483000,2144000
2023,District of Oak Bay,03-1144-00,V8R 2G5,,2519 CAVENDISH,1745000,1661000,243000,1904000
2023,District of Oak Bay,03-1145-00,V8R 2G6,,2586 CAVENDISH,1857000,1746000,261000,2007000
2023,District of Oak Bay,03-1146-00,V8R 2G6,,2596 CAVENDISH,1755000,1746000,172000,1918000
2023,District of Oak Bay,03-1147-00,V8R 2G6,,2608 CAVENDISH,1938000,1746000,384000,2130000
2023,District of Oak Bay,03-1148-00,V8R 2G6,,2620 CAVENDISH,2345000,1746000,848000,2594000
2023,District of Oak Bay,03-1149-00,V8R 2G6,,2632 CAVENDISH,1957000,1747000,375000,2122000
2023,District of Oak Bay,03-1150-00,V8R 2G6,,2644 CAVENDISH,1979000,1747000,428000,2175000
2023,District of Oak Bay,03-1151-00,V8R 2G6,,2656 CAVENDISH,1791000,1747000,213000,1960000
2023,District of Oak Bay,03-1152-00,V8R 2G6,,2668 CAVENDISH,1778000,1747000,194000,1941000
2023,District of Oak Bay,03-1153-00,V8R 6J8,,2140 BEACH,1943000,1749000,391000,2140000
2023,District of Oak Bay,03-1153-00,V8R 6J8,,2140 BEACH,1943000,1749000,391000,2140000
2023,District of Oak Bay,03-1154-00,V8R 6J8,,2120 BEACH,2150000,1746000,631000,2377000
2023,District of Oak Bay,03-1155-00,V8R 6J9,,2121 BEACH,1840000,1751000,283000,2034000
2023,District of Oak Bay,03-1156-00,V8R 6J9,,2141 BEACH,1799000,1751000,202000,1953000
2023,District of Oak Bay,03-1157-00,V8R 2G8,,2756 CAVENDISH,2426100,2562000,40900,2602900
2023,District of Oak Bay,03-1158-00,V8R 2W1,,2168 ESPLANADE,2739000,2565000,348000,2913000
2023,District of Oak Bay,03-1159-00,V8R 2W1,,2170 ESPLANADE,2024000,1969000,204000,2173000
2023,District of Oak Bay,03-1160-00,V8R 1G2,, DALHOUSIE,1667000,1756000,0,1756000
2023,District of Oak Bay,03-1161-00,V8R 2J1,,2741 DALHOUSIE,2725000,2014000,999000,3013000
2023,District of Oak Bay,03-1163-00,V8S 4T8,,2180 BEACH,1865000,1748000,295000,2043000
2023,District of Oak Bay,03-1164-00,V8R 6J8,,2160 BEACH,1900000,1748000,326000,2074000
2023,District of Oak Bay,03-1164-00,V8R 6J8,,2160 BEACH,1900000,1748000,326000,2074000
2023,District of Oak Bay,03-1165-00,V5V 2J2,,2663 DALHOUSIE,1835000,1749000,280000,2029000
2023,District of Oak Bay,03-1166-00,V8R 2H8,,2653 DALHOUSIE,2612000,1751000,1152000,2903000
2023,District of Oak Bay,03-1167-00,V8R 2H8,,2643 DALHOUSIE,1822000,1752000,239000,1991000
2023,District of Oak Bay,03-1168-00,V8R 2H8,,2629 DALHOUSIE,1776000,1753000,184000,1937000
2023,District of Oak Bay,03-1169-00,V8R 2H8,,2619 DALHOUSIE,1802000,1754000,235000,1989000
2023,District of Oak Bay,03-1170-00,V8R 2H8,,2605 DALHOUSIE,1674300,1755000,75900,1830900
2023,District of Oak Bay,03-1171-00,V8R 2H8,,2595 DALHOUSIE,1782000,1750000,197000,1947000
2023,District of Oak Bay,03-1172-00,V8R 2H9,,2596 DALHOUSIE,1762000,1747000,181000,1928000
2023,District of Oak Bay,03-1173-00,V8R 2H9,,2606 DALHOUSIE,1749000,1750000,162000,1912000
2023,District of Oak Bay,03-1174-00,V8R 2H9,,2618 DALHOUSIE,1708000,1750000,113000,1863000
2023,District of Oak Bay,03-1174-00,V0R 2P2,,2618 DALHOUSIE,1708000,1750000,113000,1863000
2023,District of Oak Bay,03-1175-00,V8R 2H9,,2630 DALHOUSIE,1749000,1749000,160000,1909000
2023,District of Oak Bay,03-1176-00,V8R 2H9,,2642 DALHOUSIE,1795000,1749000,207000,1956000
2023,District of Oak Bay,03-1177-00,V8R 2H9,,2654 DALHOUSIE,1852000,1749000,277000,2026000
2023,District of Oak Bay,03-1178-00,V8R 2H9,,2666 DALHOUSIE,3885000,1749000,2458000,4207000
2023,District of Oak Bay,03-1179-00,V8R 6K1,,2240 BEACH,1925000,1922000,171000,2093000
2023,District of Oak Bay,03-1179-00,V8R 6K1,,2240 BEACH,1925000,1922000,171000,2093000
2023,District of Oak Bay,03-1180-00,V8R 6K1,,2218 BEACH,2622000,1922000,965000,2887000
2023,District of Oak Bay,03-1180-00,V8R 6K1,,2218 BEACH,2622000,1922000,965000,2887000
2023,District of Oak Bay,03-1183-00,V8R 2N2,,2452 HAMIOTA,1462000,1479000,119000,1598000
2023,District of Oak Bay,03-1183-00,V8N 1W1,,2452 HAMIOTA,1462000,1479000,119000,1598000
2023,District of Oak Bay,03-1184-00,V8R 2N2,,2448 HAMIOTA,1475000,1479000,132000,1611000
2023,District of Oak Bay,03-1185-00,V8R 2N2,,2436 HAMIOTA,1468000,1479000,126000,1605000
2023,District of Oak Bay,03-1186-00,V8R 2N2,,2424 HAMIOTA,1553000,1479000,221000,1700000
2023,District of Oak Bay,03-1187-00,V8R 2N2,,2418 HAMIOTA,2199000,1479000,985000,2464000
2023,District of Oak Bay,03-1188-00,V8R 2N2,,2406 HAMIOTA,1497000,1479000,159000,1638000
2023,District of Oak Bay,03-1189-00,V8Z 6B6,,2396 HAMIOTA,1385400,1479000,36600,1515600
2023,District of Oak Bay,03-1190-00,V8R 2N2,,2384 HAMIOTA,1471000,1479000,151000,1630000
2023,District of Oak Bay,03-1191-00,V8R 2N2,,2370 HAMIOTA,1539000,1479000,200000,1679000
2023,District of Oak Bay,03-1192-00,V8R 2N2,,2358 HAMIOTA,2215000,1479000,1018000,2497000
2023,District of Oak Bay,03-1193-00,V8R 2N2,,2348 HAMIOTA,1493000,1471000,159000,1630000
2023,District of Oak Bay,03-1194-00,V8R 2N2,,2346 HAMIOTA,1560000,1500000,210000,1710000
2023,District of Oak Bay,03-1195-00,V8R 2N2,,2342 HAMIOTA,1506000,1392000,254000,1646000
2023,District of Oak Bay,03-1198-00,V8R 2N1,,2465 HAMIOTA,1882000,1751000,332000,2083000
2023,District of Oak Bay,03-1199-00,V8R 2N1,,2455 HAMIOTA,1776000,1729000,198000,1927000
2023,District of Oak Bay,03-1200-00,V8R 2N1,,2445 HAMIOTA,1984000,1728000,462000,2190000
2023,District of Oak Bay,03-1201-00,V8R 2N1,,2433 HAMIOTA,1652000,1480000,304000,1784000
2023,District of Oak Bay,03-1202-00,V8R 2N1,,2423 HAMIOTA,1828000,1480000,513000,1993000
2023,District of Oak Bay,03-1203-00,V8P 1W8,,2417 HAMIOTA,1499000,1479000,152000,1631000
2023,District of Oak Bay,03-1203-00,V8P 1W8,,2417 HAMIOTA,1499000,1479000,152000,1631000
2023,District of Oak Bay,03-1204-00,V8R 2N1,,2405 HAMIOTA,1484000,1479000,140000,1619000
2023,District of Oak Bay,03-1205-00,V8R 2N1,,2403 HAMIOTA,1484000,1479000,143000,1622000
2023,District of Oak Bay,03-1206-00,V8R 2N1,,2387 HAMIOTA,1513000,1479000,169000,1648000
2023,District of Oak Bay,03-1207-00,V8R 2N1,,2371 HAMIOTA,1523000,1478000,184000,1662000
2023,District of Oak Bay,03-1208-00,V8R 2N1,,2359 HAMIOTA,1594000,1478000,259000,1737000
2023,District of Oak Bay,03-1209-00,V8R 2N1,,2347 HAMIOTA,1466000,1477000,123000,1600000
2023,District of Oak Bay,03-1210-00,V8R 6G5,,2345 HAMIOTA,1474000,1477000,135000,1612000
2023,District of Oak Bay,03-1211-00,V8R 2N1,,2343 HAMIOTA,1218500,1244000,88800,1332800
2023,District of Oak Bay,03-1212-00,V8R 2M9,,2352 TOD,1114300,1166000,51400,1217400
2023,District of Oak Bay,03-1213-00,V6K 2J8,,2333 HAMIOTA,1971000,1477000,706000,2183000
2023,District of Oak Bay,04-1218-00,V8S 4Y5,,1405 ST. PATRICK,1833000,1402000,618000,2020000
2023,District of Oak Bay,04-1219-00,V8S 4Y5,,1383 ST. PATRICK,2149000,1835000,494000,2329000
2023,District of Oak Bay,04-1220-00,V8S 4Z3,,1392 ST. DAVID,2647000,1840000,1044000,2884000
2023,District of Oak Bay,04-1221-00,V8S 4Y5,,1359 ST. PATRICK,2771000,1835000,1153000,2988000
2023,District of Oak Bay,04-1221-00,V8S 4Y5,,1359 ST. PATRICK,2771000,1835000,1153000,2988000
2023,District of Oak Bay,04-1222-00,V8S 4Z3,,1354 ST. DAVID,3239000,1838000,1772000,3610000
2023,District of Oak Bay,04-1223-00,V8S 4Y5,,1329 ST. PATRICK,1655000,1494000,280000,1774000
2023,District of Oak Bay,04-1224-00,V8S 2G3,,2346 BRIGHTON,1521000,1312000,329000,1641000
2023,District of Oak Bay,04-1225-00,V8S 4Z3,,1324 ST. DAVID,2340000,1836000,692000,2528000
2023,District of Oak Bay,04-1240-00,V8R 2N5,,2246 KINROSS,1035000,1003000,120000,1123000
2023,District of Oak Bay,04-1240-01,V8R 2N5,,2248 KINROSS,1055000,1003000,139000,1142000
2023,District of Oak Bay,04-1240-02,V8R 2N5,,2250 KINROSS,1044000,1003000,132000,1135000
2023,District of Oak Bay,04-1240-03,V8R 2N5,,2252 KINROSS,1065000,952000,199000,1151000
2023,District of Oak Bay,04-1241-00,V8R 3J1,,2282 HARLOW,1050000,924000,204000,1128000
2023,District of Oak Bay,04-1242-00,V8R 5J7,,2716 CADBORO BAY,1637000,934000,925000,1859000
2023,District of Oak Bay,04-1243-00,J8T 1G6,,2724 CADBORO BAY,999000,942000,145000,1087000
2023,District of Oak Bay,04-1244-00,V8R 5J7,,2732 CADBORO BAY,1012000,951000,149000,1100000
2023,District of Oak Bay,04-1245-00,V8R 5J7,,2738 CADBORO BAY,2310000,959000,1668000,2627000
2023,District of Oak Bay,04-1246-00,V8R 3C4,,2275 ALLENBY,1388000,1192000,314000,1506000
2023,District of Oak Bay,04-1246-00,V9A 2T8,,2275 ALLENBY,1388000,1192000,314000,1506000
2023,District of Oak Bay,04-1247-00,V8R 3J1,,2278 HARLOW,1183000,1156000,131000,1287000
2023,District of Oak Bay,04-1248-00,V8R 5J8,,2760 CADBORO BAY,1001000,905000,186000,1091000
2023,District of Oak Bay,04-1249-00,V8R 5J8,,2768 CADBORO BAY,973000,914000,141000,1055000
2023,District of Oak Bay,04-1250-00,V8R 5J8,,2776 CADBORO BAY,879600,923000,35000,958000
2023,District of Oak Bay,04-1251-00,V8R 5J8,,2784 CADBORO BAY,973000,920000,137000,1057000
2023,District of Oak Bay,04-1252-00,V8R 5J8,,2796 CADBORO BAY,1020000,878000,230000,1108000
2023,District of Oak Bay,04-1253-00,V8R 3E5,,2275 NEIL,1300000,1118000,387000,1505000
2023,District of Oak Bay,04-1254-00,V8R 3E5,,2269 NEIL,1075000,1046000,123000,1169000
2023,District of Oak Bay,04-1255-00,V8R 3E5,,2263 NEIL,1175000,1077000,191000,1268000
2023,District of Oak Bay,04-1256-00,V8R 3E5,,2257 NEIL,1312000,1258000,169000,1427000
2023,District of Oak Bay,04-1259-00,V8R 3C5,,2258 ALLENBY,2027000,1261000,994000,2255000
2023,District of Oak Bay,04-1260-00,V8M 1M8,,2264 ALLENBY,1097000,1079000,113000,1192000
2023,District of Oak Bay,04-1261-00,V6L 1E7,,2270 ALLENBY,1814000,1079000,1004000,2083000
2023,District of Oak Bay,04-1262-00,V8R 3C5,,2278 ALLENBY,1858000,1079000,1041000,2120000
2023,District of Oak Bay,04-1263-00,V8R 5J9,,2812 CADBORO BAY,1133000,958000,287000,1245000
2023,District of Oak Bay,04-1264-00,V8R 5J9,,2820 CADBORO BAY,980500,961000,104000,1065000
2023,District of Oak Bay,04-1266-00,V8R 3E6,,2270 NEIL,1087000,1060000,121000,1181000
2023,District of Oak Bay,04-1267-00,V8R 3L8,,2264 NEIL,1141000,1127000,116000,1243000
2023,District of Oak Bay,04-1268-00,V8R 3E6,,2258 NEIL,1310000,1159000,276000,1435000
2023,District of Oak Bay,04-1269-00,V8R 3E6,,2252 NEIL,1214000,1156000,155000,1311000
2023,District of Oak Bay,04-1273-00,V8S 2L3,,77 BEACH,2667000,2259000,991000,3250000
2023,District of Oak Bay,04-1274-00,V8S 2K8,,36 SYLVAN,2456000,2667000,278000,2945000
2023,District of Oak Bay,04-1274-00,V8S 2K8,,36 SYLVAN,2456000,2667000,278000,2945000
2023,District of Oak Bay,04-1276-00,V8R 5B1,,2573 FOUL BAY,915000,850000,146000,996000
2023,District of Oak Bay,04-1277-00,V8R 5B1,,2551 FOUL BAY,974000,849000,204000,1053000
2023,District of Oak Bay,04-1278-00,V8P 3S7,,2529 FOUL BAY,907000,850000,137000,987000
2023,District of Oak Bay,04-1279-00,V9A 7E9,,2507 FOUL BAY,913000,849000,141000,990000
2023,District of Oak Bay,04-1279-00,V8R 5B1,,2507 FOUL BAY,913000,849000,141000,990000
2023,District of Oak Bay,04-1280-00,V8R 5B1,,2469 FOUL BAY,928000,850000,160000,1010000
2023,District of Oak Bay,04-1281-00,V8R 5B1,,2465 FOUL BAY,950000,849000,184000,1033000
2023,District of Oak Bay,04-1282-00,V8R 5B1,,2443 FOUL BAY,827200,849000,48200,897200
2023,District of Oak Bay,04-1283-00,V8R 5B1,,2421 FOUL BAY,892000,849000,117000,966000
2023,District of Oak Bay,04-1284-00,V8R 5B1,,2397 FOUL BAY,780000,849000,364000,1213000
2023,District of Oak Bay,04-1285-00,V8R 5B1,,2371 FOUL BAY,897000,849000,126000,975000
2023,District of Oak Bay,04-1286-00,V8R 4Z6,,2349 FOUL BAY,912000,849000,135000,984000
2023,District of Oak Bay,04-1287-00,V8R 4Z6,,2327 FOUL BAY,854500,849000,72100,921100
2023,District of Oak Bay,04-1288-00,V8R 5B1,,2303 FOUL BAY,835500,849000,66900,915900
2023,District of Oak Bay,04-1289-00,V8R 5B1,,2281 FOUL BAY,918000,849000,156000,1005000
2023,District of Oak Bay,04-1290-00,V8R 5B1,,2257 FOUL BAY,911000,849000,140000,989000
2023,District of Oak Bay,04-1291-00,V8R 5B1,,2237 FOUL BAY,1154000,849000,434000,1283000
2023,District of Oak Bay,04-1291-01,V8R 5B1,,2215 FOUL BAY,762000,697000,118000,815000
2023,District of Oak Bay,04-1292-00,V8R 5B1,,2183 FOUL BAY,1050000,875000,259000,1134000
2023,District of Oak Bay,04-1293-00,V8R 5B1,,2161 FOUL BAY,876900,875000,84700,959700
2023,District of Oak Bay,04-1294-00,V8R 5B1,,2139 FOUL BAY,928000,820000,185000,1005000
2023,District of Oak Bay,04-1301-00,V8R 5E8,,2130 FLORENCE,1232000,1145000,192000,1337000
2023,District of Oak Bay,04-1301-00,V8R 3T2,,2130 FLORENCE,1232000,1145000,192000,1337000
2023,District of Oak Bay,04-1302-00,V8R 5E8,,2138 FLORENCE,1189000,1061000,264000,1325000
2023,District of Oak Bay,04-1303-00,V8R 5E8,,2160 FLORENCE,1061600,1061000,103000,1164000
2023,District of Oak Bay,04-1304-00,V8R 5E8,,2182 FLORENCE,1038800,1061000,73000,1134000
2023,District of Oak Bay,04-1305-00,V6N 4J5,,2214 FLORENCE,1360000,1270000,231000,1501000
2023,District of Oak Bay,04-1305-00,V6N 4J5,,2214 FLORENCE,1360000,1270000,231000,1501000
2023,District of Oak Bay,04-1307-00,V8R 5E8,,2258 FLORENCE,1579000,1062000,698000,1760000
2023,District of Oak Bay,04-1308-00,V8R 5E8,,2280 FLORENCE,1563000,1061000,695000,1756000
2023,District of Oak Bay,04-1309-00,V8R 5E8,,2302 FLORENCE,1089000,1062000,123000,1185000
2023,District of Oak Bay,04-1310-00,V4B 3A3,,2324 FLORENCE,1226000,1062000,287000,1349000
2023,District of Oak Bay,04-1311-00,V8R 5E8,,2348 FLORENCE,1105000,1062000,600000,1662000
2023,District of Oak Bay,04-1312-00,V8R 5E8,,2372 FLORENCE,1150000,1062000,177000,1239000
2023,District of Oak Bay,04-1313-00,V8S 4G6,,2398 FLORENCE,1095000,1062000,138000,1200000
2023,District of Oak Bay,04-1313-00,V8N 3P1,,2398 FLORENCE,1095000,1062000,138000,1200000
2023,District of Oak Bay,04-1314-00,V8R 5E8,,2418 FLORENCE,1025300,1062000,60500,1122500
2023,District of Oak Bay,04-1315-00,V8R 5E8,,2444 FLORENCE,1094000,1062000,143000,1205000
2023,District of Oak Bay,04-1316-00,V8R 5E8,,2466 FLORENCE,1057300,1062000,84900,1146900
2023,District of Oak Bay,04-1317-00,V8R 5E8,,2488 FLORENCE,1050000,1062000,89100,1151100
2023,District of Oak Bay,04-1318-00,V8R 5E8,,2508 FLORENCE,1076000,1062000,107000,1169000
2023,District of Oak Bay,04-1319-00,K7G 2V6,,2530 FLORENCE,1074500,1062000,102000,1164000
2023,District of Oak Bay,04-1320-00,V8V 1M4,,2552 FLORENCE,1018800,1062000,46900,1108900
2023,District of Oak Bay,04-1321-00,V8R 5E8,,2574 FLORENCE,1000100,1020000,72500,1092500
2023,District of Oak Bay,04-1322-00,V8R 5E7,,2573 FLORENCE,1093000,1009000,179000,1188000
2023,District of Oak Bay,04-1323-00,V8R 5E7,,2551 FLORENCE,1107000,1062000,141000,1203000
2023,District of Oak Bay,04-1324-00,V8R 5E7,,2529 FLORENCE,1047700,1062000,79300,1141300
2023,District of Oak Bay,04-1325-00,V8R 5E7,,2507 FLORENCE,1105000,1062000,134000,1196000
2023,District of Oak Bay,04-1326-00,V8R 5E7,,2487 FLORENCE,1038900,1062000,76600,1138600
2023,District of Oak Bay,04-1327-00,V8R 5E7,,2465 FLORENCE,1441000,1062000,501000,1563000
2023,District of Oak Bay,04-1328-00,V8R 5E7,,2443 FLORENCE,1621000,1062000,783000,1845000
2023,District of Oak Bay,04-1329-00,V8R 5E7,,2421 FLORENCE,1105000,1063000,147000,1210000
2023,District of Oak Bay,04-1330-00,V8R 5E7,,2399 FLORENCE,1283000,1062000,389000,1451000
2023,District of Oak Bay,04-1331-00,V6R 1B3,,2369 FLORENCE,1351000,1063000,416000,1479000
2023,District of Oak Bay,04-1332-00,V8R 5E7,,2349 FLORENCE,1121000,1063000,169000,1232000
2023,District of Oak Bay,04-1333-00,V8R 5E7,,2327 FLORENCE,1082000,1063000,115000,1178000
2023,District of Oak Bay,04-1334-00,V8R 5E7,,2303 FLORENCE,1203000,1063000,242000,1305000
2023,District of Oak Bay,04-1335-00,V8R 5E7,,2281 FLORENCE,1152000,1063000,173000,1236000
2023,District of Oak Bay,04-1336-00,V8R 5E7,,2259 FLORENCE,1086000,1063000,115000,1178000
2023,District of Oak Bay,04-1337-00,V8R 5E7,,2237 FLORENCE,1218000,1063000,272000,1335000
2023,District of Oak Bay,04-1338-00,V8R 5E7,,2215 FLORENCE,1066400,1063000,95600,1158600
2023,District of Oak Bay,04-1339-00,V8R 5E7,,2183 FLORENCE,1175000,1063000,218000,1281000
2023,District of Oak Bay,04-1340-00,V8R 5E7,,2161 FLORENCE,1119000,1063000,142000,1205000
2023,District of Oak Bay,04-1341-00,V8R 5E7,,2139 FLORENCE,1048400,1063000,86600,1149600
2023,District of Oak Bay,04-1344-00,V8T 1K5,,2072 CADBORO BAY,1870000,1271000,919000,2190000
2023,District of Oak Bay,04-1347-00,V8R 5L1,,2140 EPWORTH,1090000,1010000,174000,1184000
2023,District of Oak Bay,04-1348-00,V8R 5L1,,2162 EPWORTH,1060500,1063000,93200,1156200
2023,District of Oak Bay,04-1349-00,V8R 5L1,,2184 EPWORTH,1132000,1063000,197000,1260000
2023,District of Oak Bay,04-1350-00,V8V 3G4,,2210 EPWORTH,1131000,1063000,158000,1221000
2023,District of Oak Bay,04-1350-00,V8V 3G4,,2210 EPWORTH,1131000,1063000,158000,1221000
2023,District of Oak Bay,04-1351-00,V8R 5L1,,2236 EPWORTH,1080000,1063000,113000,1176000
2023,District of Oak Bay,04-1352-00,V8R 5L1,,2258 EPWORTH,1168000,1063000,207000,1270000
2023,District of Oak Bay,04-1353-00,V8R 5L1,,2280 EPWORTH,1160000,1063000,204000,1267000
2023,District of Oak Bay,04-1354-00,V8R 5L1,,2304 EPWORTH,1554000,1062000,673000,1735000
2023,District of Oak Bay,04-1355-00,V8R 5L1,,2326 EPWORTH,1103000,1063000,139000,1202000
2023,District of Oak Bay,04-1356-00,V8R 5L1,,2350 EPWORTH,1057100,1062000,96200,1158200
2023,District of Oak Bay,04-1357-00,V8R 5L1,,2368 EPWORTH,1298000,1063000,353000,1416000
2023,District of Oak Bay,04-1358-00,V8R 5L1,,2388 EPWORTH,1096000,1062000,154000,1216000
2023,District of Oak Bay,04-1358-01,V8S 4A7,,2414 EPWORTH,1127000,1062000,155000,1217000
2023,District of Oak Bay,04-1358-01,V9C 3V5,,2414 EPWORTH,1127000,1062000,155000,1217000
2023,District of Oak Bay,04-1359-00,V8R 5L1,,2440 EPWORTH,1282000,1063000,330000,1393000
2023,District of Oak Bay,04-1360-00,V8R 5L1,,2466 EPWORTH,1117000,1062000,166000,1228000
2023,District of Oak Bay,04-1361-00,V8R 5L1,,2490 EPWORTH,1106000,1062000,140000,1202000
2023,District of Oak Bay,04-1362-00,V8R 5L1,,2510 EPWORTH,1143000,1062000,174000,1236000
2023,District of Oak Bay,04-1363-00,V8R 5L1,,2530 EPWORTH,1068500,1062000,100000,1162000
2023,District of Oak Bay,04-1364-00,V8R 5L1,,2552 EPWORTH,1079000,1062000,111000,1173000
2023,District of Oak Bay,04-1365-00,V8R 5L1,,2574 EPWORTH,985100,1009000,63000,1072000
2023,District of Oak Bay,04-1366-00,V8R 5L3,,2573 EPWORTH,1227000,1095000,245000,1340000
2023,District of Oak Bay,04-1367-00,V8R 5L3,,2551 EPWORTH,1220000,1102000,163000,1265000
2023,District of Oak Bay,04-1368-00,V9A 0A3,,2529 EPWORTH,1188000,1110000,50900,1160900
2023,District of Oak Bay,04-1368-00,V8R 1L9,,2529 EPWORTH,1188000,1110000,50900,1160900
2023,District of Oak Bay,04-1369-00,V8R 5L3,,2507 EPWORTH,1216000,1117000,145000,1262000
2023,District of Oak Bay,04-1370-00,V8R 5L3,,2489 EPWORTH,1334000,1252000,197000,1449000
2023,District of Oak Bay,04-1370-00,V8L 5C7,,2489 EPWORTH,1334000,1252000,197000,1449000
2023,District of Oak Bay,04-1370-00,V8R 5L3,,2489 EPWORTH,1334000,1252000,197000,1449000
2023,District of Oak Bay,04-1371-00,V8R 5L3,,2465 EPWORTH,1404000,1259000,272000,1531000
2023,District of Oak Bay,04-1372-00,V8R 5L3,,2439 EPWORTH,1306000,1266000,154000,1420000
2023,District of Oak Bay,04-1373-00,V8R 5L3,,2411 EPWORTH,1281000,1265000,143000,1408000
2023,District of Oak Bay,04-1378-00,V8R 5L2,,2327 EPWORTH,1184000,1143000,139000,1282000
2023,District of Oak Bay,04-1379-00,V8R 5L2,,2303 EPWORTH,1247000,1207000,150000,1357000
2023,District of Oak Bay,04-1380-00,V8R 5L2,,2281 EPWORTH,1341000,1267000,184000,1451000
2023,District of Oak Bay,04-1381-00,V8R 5L2,,2257 EPWORTH,1154000,1125000,130000,1255000
2023,District of Oak Bay,04-1382-00,V8R 5L2,,2235 EPWORTH,1228000,1125000,209000,1334000
2023,District of Oak Bay,04-1382-00,V8R 5L2,,2235 EPWORTH,1228000,1125000,209000,1334000
2023,District of Oak Bay,04-1383-00,V9C 4A7,,2209 EPWORTH,1152000,1126000,128000,1254000
2023,District of Oak Bay,04-1384-00,V8R 5L2,,2183 EPWORTH,1166000,1126000,143000,1269000
2023,District of Oak Bay,04-1385-00,V8R 5L2,,2163 EPWORTH,1165000,1127000,142000,1269000
2023,District of Oak Bay,04-1390-00,V8V 3K2,,1513 HAMPSHIRE,3071000,1404000,1731000,3135000
2023,District of Oak Bay,04-1392-00,V8V 3K2,,2228 OAK BAY,5079000,2288000,4415000,6703000
2023,District of Oak Bay,04-1394-00,V8R 1G2,,1538 MONTEREY,1641000,1507000,293000,1800000
2023,District of Oak Bay,04-1394-00,V8R 1G2,,1538 MONTEREY,1641000,1507000,293000,1800000
2023,District of Oak Bay,04-1395-00,V8R 5V4,,1546 MONTEREY,1402000,1132000,392000,1524000
2023,District of Oak Bay,04-1396-00,V8R 5V4,,1556 MONTEREY,1101000,1144000,420000,1564000
2023,District of Oak Bay,04-1396-00,V8N 3C1,,1556 MONTEREY,1101000,1144000,420000,1564000
2023,District of Oak Bay,04-1397-00,V8R 5V4,,1564 MONTEREY,1287000,1144000,294000,1438000
2023,District of Oak Bay,04-1398-00,V8R 5V4,,1572 MONTEREY,1737000,1144000,784000,1928000
2023,District of Oak Bay,04-1399-00,V8R 5V4,,1580 MONTEREY,1353000,1144000,334000,1478000
2023,District of Oak Bay,04-1400-00,V8R 5V4,,1588 MONTEREY,1307000,1144000,276000,1420000
2023,District of Oak Bay,04-1401-00,V8R 5V4,,1598 MONTEREY,1273000,1144000,244000,1388000
2023,District of Oak Bay,04-1402-00,V8R 5V4,,1606 MONTEREY,1801000,1334000,664000,1998000
2023,District of Oak Bay,04-1402-00,V8R 5V4,,1606 MONTEREY,1801000,1334000,664000,1998000
2023,District of Oak Bay,04-1404-00,V8R 5V4,,1624 MONTEREY,1724000,1338000,563000,1901000
2023,District of Oak Bay,04-1404-00,V8R 5V4,,1624 MONTEREY,1724000,1338000,563000,1901000
2023,District of Oak Bay,04-1405-00,V8R 5V5,,1632 MONTEREY,1201000,1144000,161000,1305000
2023,District of Oak Bay,04-1406-10,V8R 5V5,,1638 MONTEREY,1625000,1173000,639000,1812000
2023,District of Oak Bay,04-1407-10,V8R 5T4,,1639 HAMPSHIRE,1528000,1183000,498000,1681000
2023,District of Oak Bay,04-1408-10,V8R 2N1,,1631 HAMPSHIRE,1524000,1198000,463000,1661000
2023,District of Oak Bay,04-1409-00,V8R 5T4,,1625 HAMPSHIRE,1289000,1168000,268000,1436000
2023,District of Oak Bay,04-1410-00,V8R 5T4,,1619 HAMPSHIRE,1153600,1168000,88800,1256800
2023,District of Oak Bay,04-1411-00,V8R 5T4,,1611 HAMPSHIRE,1956000,1168000,989000,2157000
2023,District of Oak Bay,04-1412-00,V8R 5T4,,1597 HAMPSHIRE,1836000,1170000,822000,1992000
2023,District of Oak Bay,04-1412-01,V8R 5T4,,1595 HAMPSHIRE,1835000,1166000,827000,1993000
2023,District of Oak Bay,04-1413-00,V8R 5T4,,1587 HAMPSHIRE,1274000,1168000,243000,1411000
2023,District of Oak Bay,04-1413-00,V8R 5T4,,1587 HAMPSHIRE,1274000,1168000,243000,1411000
2023,District of Oak Bay,04-1414-00,V8R 5T4,,1579 HAMPSHIRE,1219000,1169000,174000,1343000
2023,District of Oak Bay,04-1415-00,V8R 5T4,,1571 HAMPSHIRE,1370000,1168000,344000,1512000
2023,District of Oak Bay,04-1416-00,V8R 5T4,,1563 HAMPSHIRE,1130600,1168000,70700,1238700
2023,District of Oak Bay,04-1417-00,V8R 5T4,,1555 HAMPSHIRE,1217000,1168000,175000,1343000
2023,District of Oak Bay,04-1418-00,V8R 5T4,,1547 HAMPSHIRE,1236000,1168000,177000,1345000
2023,District of Oak Bay,04-1419-00,V8R 6E5,,1537 HAMPSHIRE,1244000,1156000,305000,1461000
2023,District of Oak Bay,04-1419-00,V8R 6E5,,1537 HAMPSHIRE,1244000,1156000,305000,1461000
2023,District of Oak Bay,04-1420-00,V8R 1G2,,1531 HAMPSHIRE,1061000,1034000,118000,1152000
2023,District of Oak Bay,04-1420-00,V8T 5L2,,1531 HAMPSHIRE,1061000,1034000,118000,1152000
2023,District of Oak Bay,04-1423-00,V9A 1M7,,1529 MONTEREY,1413000,1222000,308000,1530000
2023,District of Oak Bay,04-1424-00,V8R 5V3,, MONTEREY,47200,51400,0,51400
2023,District of Oak Bay,04-1424-00,V8T 2V4,, MONTEREY,47200,51400,0,51400
2023,District of Oak Bay,04-1425-00,V8T 2V4,,1539 MONTEREY,1298000,1141000,290000,1431000
2023,District of Oak Bay,04-1425-00,V8R 5V3,,1539 MONTEREY,1298000,1141000,290000,1431000
2023,District of Oak Bay,04-1426-00,V8R 5V3,,1547 MONTEREY,1327000,1153000,292000,1445000
2023,District of Oak Bay,04-1427-00,V8R 5V3,,1555 MONTEREY,1193000,1152000,177000,1329000
2023,District of Oak Bay,04-1428-00,V6Z 2E6,,1563 MONTEREY,1391000,1152000,644000,1796000
2023,District of Oak Bay,04-1429-00,V8R 5V3,,1571 MONTEREY,1246000,1152000,204000,1356000
2023,District of Oak Bay,04-1430-00,V8R 5V3,,1579 MONTEREY,1182000,1152000,141000,1293000
2023,District of Oak Bay,04-1431-00,V8R 5V3,,1587 MONTEREY,1414000,1152000,223000,1375000
2023,District of Oak Bay,04-1432-00,V8R 5V3,,1597 MONTEREY,1379000,1151000,364000,1515000
2023,District of Oak Bay,04-1433-00,V8R 5V3,,1605 MONTEREY,1169000,1152000,134000,1286000
2023,District of Oak Bay,04-1434-00,V8R 5V3,,1617 MONTEREY,1401000,1152000,393000,1545000
2023,District of Oak Bay,04-1435-00,V8R 1P1,,2255 WOODLAWN,1349000,1200000,278000,1478000
2023,District of Oak Bay,04-1439-00,V8R 5T5,,1616 HAMPSHIRE,1396000,1292000,751000,2043000
2023,District of Oak Bay,04-1440-00,V8R 5T5,,1624 HAMPSHIRE,1492000,1292000,325000,1617000
2023,District of Oak Bay,04-1440-00,V8R 5T5,,1624 HAMPSHIRE,1492000,1292000,325000,1617000
2023,District of Oak Bay,04-1441-00,V8R 5T5,,1630 HAMPSHIRE,1371000,1292000,196000,1488000
2023,District of Oak Bay,04-1442-00,V8R 5T5,,1636 HAMPSHIRE,1584000,1292000,451000,1743000
2023,District of Oak Bay,04-1443-00,V8R 5T5,,1650 HAMPSHIRE,1480000,1292000,313000,1605000
2023,District of Oak Bay,04-1444-00,V8R 5T5,,1654 HAMPSHIRE,2505000,1297000,1520000,2817000
2023,District of Oak Bay,04-1445-00,V8R 5S3,,1649 WILMOT,1472000,1345000,444000,1789000
2023,District of Oak Bay,04-1446-00,V8R 5S3,,1641 WILMOT,2366000,1331000,1381000,2712000
2023,District of Oak Bay,04-1447-00,V8R 5S3,,1633 WILMOT,1498000,1331000,294000,1625000
2023,District of Oak Bay,04-1448-00,V8R 5S3,,1627 WILMOT,1479000,1331000,285000,1616000
2023,District of Oak Bay,04-1449-00,V8R 5S3,,1619 WILMOT,1537000,1331000,347000,1678000
2023,District of Oak Bay,04-1450-00,V8R 5S3,,1617 WILMOT,1513000,1330000,332000,1662000
2023,District of Oak Bay,04-1451-00,V8R 5S4,,1612 WILMOT,1341000,1330000,149000,1479000
2023,District of Oak Bay,04-1452-00,V8R 5S4,,1618 WILMOT,2460000,1329000,1524000,2853000
2023,District of Oak Bay,04-1453-00,V8R 5S4,,1626 WILMOT,1457000,1376000,231000,1607000
2023,District of Oak Bay,04-1454-00,V8R 5S4,,1632 WILMOT,1348000,1280000,180000,1460000
2023,District of Oak Bay,04-1455-00,V8R 5S4,,1638 WILMOT,1371000,1329000,165000,1494000
2023,District of Oak Bay,04-1456-00,V8R 5S4,,1648 WILMOT,2583000,1345000,1583000,2928000
2023,District of Oak Bay,04-1457-00,V8R 5N5,,1697 YALE,1380000,1311000,187000,1498000
2023,District of Oak Bay,04-1458-00,V8R 5N5,,1689 YALE,1379000,1355000,141000,1496000
2023,District of Oak Bay,04-1459-00,V9H 1E7,,1685 YALE,1422000,1355000,189000,1544000
2023,District of Oak Bay,04-1460-00,V8X 1V6,,1675 YALE,1362000,1355000,125000,1480000
2023,District of Oak Bay,04-1461-00,V8R 5N5,,1667 YALE,1602000,1291000,473000,1764000
2023,District of Oak Bay,04-1462-00,V8R 5N5,,1657 YALE,1408000,1291000,239000,1530000
2023,District of Oak Bay,04-1463-00,V8R 1P2,,2272 WOODLAWN,1792000,1265000,624000,1889000
2023,District of Oak Bay,04-1464-01,V8R 1P2,,2276 WOODLAWN,1935000,1345000,730000,2075000
2023,District of Oak Bay,04-1464-02,V8R 1P2,,2278 WOODLAWN,2710000,1375000,1709000,3084000
2023,District of Oak Bay,04-1466-00,V8R 1P2,,2280 WOODLAWN,1579000,1410000,320000,1730000
2023,District of Oak Bay,04-1467-00,V0R 1X7,,2285 WOODLAWN,2533000,1488000,1337000,2825000
2023,District of Oak Bay,04-1468-00,V8R 1P1,,2281 WOODLAWN,2898000,1585000,1728000,3313000
2023,District of Oak Bay,04-1469-00,V8R 1P1,,2275 WOODLAWN,1360000,1315000,183000,1498000
2023,District of Oak Bay,04-1470-00,V8R 1P1,,2271 WOODLAWN,1666000,1346000,476000,1822000
2023,District of Oak Bay,04-1471-00,V8S 3E4,,2307 WINDSOR,1771000,1563000,333000,1896000
2023,District of Oak Bay,04-1471-00,V8S 3E4,,2307 WINDSOR,1771000,1563000,333000,1896000
2023,District of Oak Bay,04-1474-00,V8S 4Y1,,1084 ST. PATRICK,1428000,1199000,348000,1547000
2023,District of Oak Bay,04-1475-00,V8S 4W8,,1073 OLIVER,1549000,1272000,416000,1688000
2023,District of Oak Bay,04-1476-00,V8S 4W8,,1067 OLIVER,1933000,1272000,887000,2159000
2023,District of Oak Bay,04-1477-00,V8S 4W8,,1059 OLIVER,1391000,1272000,220000,1492000
2023,District of Oak Bay,04-1478-00,V8S 4W8,,1051 OLIVER,1309000,1272000,148000,1420000
2023,District of Oak Bay,04-1479-00,V8S 4W8,,1041 OLIVER,1310000,1273000,135000,1408000
2023,District of Oak Bay,04-1480-01,V8S 4W8,,1035 OLIVER,1601000,1272000,521000,1793000
2023,District of Oak Bay,04-1480-02,V8S 4W8,,1027 OLIVER,1714000,1272000,624000,1896000
2023,District of Oak Bay,04-1482-00,V8S 4Y1,,1072 ST. PATRICK,1315000,1285000,151000,1436000
2023,District of Oak Bay,04-1483-00,V8S 4Y1,,1066 ST. PATRICK,1254000,1285000,69900,1354900
2023,District of Oak Bay,04-1484-00,V8S 4Y1,,1058 ST. PATRICK,1436000,1285000,261000,1546000
2023,District of Oak Bay,04-1485-00,V8S 4Y1,,1050 ST. PATRICK,1885000,1674000,362000,2036000
2023,District of Oak Bay,04-1485-00,V8S 4Y1,,1050 ST. PATRICK,1885000,1674000,362000,2036000
2023,District of Oak Bay,04-1487-00,V8S 4Y1,,1034 ST. PATRICK,1547000,1285000,398000,1683000
2023,District of Oak Bay,04-1488-00,V8S 4Y1,,1022 ST. PATRICK,1329000,1285000,140000,1425000
2023,District of Oak Bay,04-1489-00,V8S 4W8,,1017 OLIVER,1207000,1139000,152000,1291000
2023,District of Oak Bay,04-1490-00,V8S 2Y9,,2312 MCNEILL,1411000,1139000,394000,1533000
2023,District of Oak Bay,04-1491-00,V8S 2Y9,,2318 MCNEILL,1180000,1139000,126000,1265000
2023,District of Oak Bay,04-1492-00,V8S 2Y9,,2324 MCNEILL,1170000,1139000,129000,1268000
2023,District of Oak Bay,04-1493-00,V8S 4Y1,,1014 ST. PATRICK,1575000,1139000,555000,1694000
2023,District of Oak Bay,04-1494-00,V8S 3E2,,2267 WINDSOR,1188100,1199000,83300,1282300
2023,District of Oak Bay,04-1495-00,V8S 3E2,,2275 WINDSOR,1253000,1199000,162000,1361000
2023,District of Oak Bay,04-1496-00,V8S 3E2,,2281 WINDSOR,1241000,1199000,156000,1355000
2023,District of Oak Bay,04-1497-01,V8S 3E2,,2287 WINDSOR,1633000,1199000,581000,1780000
2023,District of Oak Bay,04-1497-02,V8S 4W7,,1078 OLIVER,1706000,1199000,650000,1849000
2023,District of Oak Bay,04-1499-00,V8S 4V4,,1073 MONTEREY,1772000,1235000,687000,1922000
2023,District of Oak Bay,04-1500-00,V8S 4V4,,1065 MONTEREY,1428000,1199000,393000,1592000
2023,District of Oak Bay,04-1501-00,V8S 4V4,,1057 MONTEREY,1253000,1235000,125000,1360000
2023,District of Oak Bay,04-1502-00,V8S 4V4,,1049 MONTEREY,1486000,1236000,360000,1596000
2023,District of Oak Bay,04-1503-00,V8S 4V4,,1041 MONTEREY,1290000,1235000,152000,1387000
2023,District of Oak Bay,04-1504-00,V8S 4V4,,1033 MONTEREY,1757000,1235000,674000,1909000
2023,District of Oak Bay,04-1505-00,V8S 4V4,,1025 MONTEREY,1495000,1235000,387000,1622000
2023,District of Oak Bay,04-1506-00,V8S 4W7,,1074 OLIVER,2020000,1272000,912000,2184000
2023,District of Oak Bay,04-1507-00,V8S 4W7,,1066 OLIVER,1525000,1272000,392000,1664000
2023,District of Oak Bay,04-1508-00,V8S 4W7,,1058 OLIVER,1336000,1272000,160000,1432000
2023,District of Oak Bay,04-1509-00,V8S 4W7,,1050 OLIVER,2430000,1272000,1503000,2775000
2023,District of Oak Bay,04-1510-00,V8S 4W7,,1044 OLIVER,1459000,1272000,299000,1571000
2023,District of Oak Bay,04-1511-00,V8S 4W7,,1034 OLIVER,1460000,1272000,306000,1578000
2023,District of Oak Bay,04-1512-00,V8S 4W7,,1026 OLIVER,1313000,1272000,161000,1433000
2023,District of Oak Bay,04-1513-01,V8S 4V4,,1017 MONTEREY,1314000,1199000,210000,1409000
2023,District of Oak Bay,04-1514-00,V8S 4V4,,1009 MONTEREY,1262000,1150000,205000,1355000
2023,District of Oak Bay,04-1515-00,V8S 2Y8,,2270 MCNEILL,1272000,1138000,223000,1361000
2023,District of Oak Bay,04-1516-00,V8S 2Y8,,2280 MCNEILL,1181000,1139000,127000,1266000
2023,District of Oak Bay,04-1517-00,V8S 4W7,,1010 OLIVER,1229000,1139000,179000,1318000
2023,District of Oak Bay,04-1518-00,V8R 5V6,,1639 MONTEREY,1705000,1342000,530000,1872000
2023,District of Oak Bay,05-1540-00,V8R 1G2,, NEWPORT,449000,481000,0,481000
2023,District of Oak Bay,05-1541-00,V8S 5C8,,877 NEWPORT,1733000,1658000,424000,2082000
2023,District of Oak Bay,05-1542-00,V8S 5C8,,865 NEWPORT,1626000,1572000,373000,1945000
2023,District of Oak Bay,05-1547-00,V8S 5C8,,831 NEWPORT,2481000,1560000,1434000,2994000
2023,District of Oak Bay,05-1548-00,V8S 5C8,,821 NEWPORT,1419000,1574000,134000,1708000
2023,District of Oak Bay,05-1549-00,V8S 5C8,,805 NEWPORT,2198000,2050000,593000,2643000
2023,District of Oak Bay,05-1549-00,V8S 5C8,,805 NEWPORT,2198000,2050000,593000,2643000
2023,District of Oak Bay,05-1550-00,V8S 5C8,,795 NEWPORT,1532000,1584000,250000,1834000
2023,District of Oak Bay,05-1550-00,T2P 1C9,,795 NEWPORT,1532000,1584000,250000,1834000
2023,District of Oak Bay,05-1551-00,V8S 5C8,,787 NEWPORT,1440000,1565000,153000,1718000
2023,District of Oak Bay,05-1552-00,V8S 5C8,,767 NEWPORT,2017000,1579000,784000,2363000
2023,District of Oak Bay,05-1553-00,V8S 5C8,,759 NEWPORT,1444000,1563000,172000,1735000
2023,District of Oak Bay,05-1554-00,V8S 5C8,,745 NEWPORT,1759000,1819000,288000,2107000
2023,District of Oak Bay,05-1555-00,V8S 5C8,,725 NEWPORT,1697000,1833000,208000,2041000
2023,District of Oak Bay,05-1556-00,V8S 5C8,,713 NEWPORT,2485000,1795000,1193000,2988000
2023,District of Oak Bay,05-1557-00,V8S 5C9,,988 NEWPORT,2419000,1941000,715000,2656000
2023,District of Oak Bay,05-1557-00,V8S 5C9,,988 NEWPORT,2419000,1941000,715000,2656000
2023,District of Oak Bay,05-1558-00,V8S 5C6,,964 NEWPORT,2212000,1505000,946000,2451000
2023,District of Oak Bay,05-1558-00,V8S 5C9,,964 NEWPORT,2212000,1505000,946000,2451000
2023,District of Oak Bay,05-1559-00,V8S 5C9,,954 NEWPORT,1959000,1909000,224000,2133000
2023,District of Oak Bay,05-1561-00,V8S 5C9,,942 NEWPORT,1517000,1465000,163000,1628000
2023,District of Oak Bay,05-1562-00,V8S 5C9,,920 NEWPORT,1553000,1466000,201000,1667000
2023,District of Oak Bay,05-1563-00,V8S 5C9,,912 NEWPORT,2097000,1533000,961000,2494000
2023,District of Oak Bay,05-1563-05,V8S 5C9,,906 NEWPORT,1969000,1443000,722000,2165000
2023,District of Oak Bay,05-1566-00,V8S 5C4,,975 LINKLEAS,1599000,1355000,387000,1742000
2023,District of Oak Bay,05-1567-00,V8S 5C4,,943 LINKLEAS,1470000,1395000,184000,1579000
2023,District of Oak Bay,05-1568-00,V8S 5C9,,898 NEWPORT,1422000,1362000,164000,1526000
2023,District of Oak Bay,05-1569-00,V8S 5C9,,878 NEWPORT,1424000,1268000,263000,1531000
2023,District of Oak Bay,05-1570-00,V8S 5C9,,866 NEWPORT,1412000,1253000,269000,1522000
2023,District of Oak Bay,05-1571-00,V8S 5C9,,854 NEWPORT,1491000,1253000,373000,1626000
2023,District of Oak Bay,05-1572-00,V8S 5C9,,844 NEWPORT,1289000,1253000,149000,1402000
2023,District of Oak Bay,05-1572-00,V9Y 9C7,,844 NEWPORT,1289000,1253000,149000,1402000
2023,District of Oak Bay,05-1573-00,V8S 5C9,,832 NEWPORT,1651000,1253000,551000,1804000
2023,District of Oak Bay,05-1574-00,V8S 5C9,,822 NEWPORT,2537000,1253000,1607000,2860000
2023,District of Oak Bay,05-1575-00,V8S 5C9,,812 NEWPORT,1447000,1253000,307000,1560000
2023,District of Oak Bay,05-1576-00,V8S 5C9,,800 NEWPORT,1405000,1253000,246000,1499000
2023,District of Oak Bay,05-1577-00,V8S 5C9,,792 NEWPORT,1647000,1253000,544000,1797000
2023,District of Oak Bay,05-1578-00,V8S 5C9,,780 NEWPORT,1400000,1253000,227000,1480000
2023,District of Oak Bay,05-1579-00,V8S 5C9,,768 NEWPORT,1991000,1253000,923000,2176000
2023,District of Oak Bay,05-1580-00,V8S 5C9,,758 NEWPORT,1469000,1253000,343000,1596000
2023,District of Oak Bay,05-1581-00,V8S 5C9,,746 NEWPORT,1310000,1253000,148000,1401000
2023,District of Oak Bay,05-1582-00,V8S 5C9,,736 NEWPORT,1481000,1253000,342000,1595000
2023,District of Oak Bay,05-1583-00,V8S 5C9,,724 NEWPORT,1412000,1253000,258000,1511000
2023,District of Oak Bay,05-1584-00,V8S 5C9,,714 NEWPORT,1578000,1356000,353000,1709000
2023,District of Oak Bay,05-1585-00,V8S 5C4,,885 LINKLEAS,2319000,1193000,1399000,2592000
2023,District of Oak Bay,05-1586-00,V8S 5C4,,875 LINKLEAS,1298000,1194000,197000,1391000
2023,District of Oak Bay,05-1587-00,V8S 5C4,,855 LINKLEAS,1278000,1194000,175000,1369000
2023,District of Oak Bay,05-1588-00,V8S 5C4,,835 LINKLEAS,1385000,1194000,276000,1470000
2023,District of Oak Bay,05-1590-00,V8S 5C4,,831 LINKLEAS,2078000,1194000,1058000,2252000
2023,District of Oak Bay,05-1590-10,V8S 5C4,,825 LINKLEAS,1785000,1194000,744000,1938000
2023,District of Oak Bay,05-1591-00,V8S 5C4,,821 LINKLEAS,1240000,1194000,135000,1329000
2023,District of Oak Bay,05-1592-00,V8S 5C4,,811 LINKLEAS,1348000,1194000,265000,1459000
2023,District of Oak Bay,05-1593-00,V8S 5C4,,799 LINKLEAS,1625000,1395000,367000,1762000
2023,District of Oak Bay,05-1594-00,V8S 5C4,,777 LINKLEAS,1638000,1395000,384000,1779000
2023,District of Oak Bay,05-1595-00,V8S 5C4,,767 LINKLEAS,1259000,1194000,154000,1348000
2023,District of Oak Bay,05-1596-00,V3Z 9X4,,759 LINKLEAS,2549000,1194000,1717000,2911000
2023,District of Oak Bay,05-1597-00,V8S 5C4,,745 LINKLEAS,1290000,1194000,212000,1406000
2023,District of Oak Bay,05-1598-00,V8S 5C4,,737 LINKLEAS,1266000,1195000,162000,1357000
2023,District of Oak Bay,05-1599-00,V8S 2T3,,2530 CENTRAL,1343000,1198000,253000,1451000
2023,District of Oak Bay,05-1600-00,V8S 2T3,,2510 CENTRAL,1459000,1278000,300000,1578000
2023,District of Oak Bay,05-1600-00,V8S 2T3,,2510 CENTRAL,1459000,1278000,300000,1578000
2023,District of Oak Bay,05-1601-00,V8S 2Z5,,2523 MCNEILL,1905000,1191000,940000,2131000
2023,District of Oak Bay,05-1602-00,V8X 1M2,,982 LINKLEAS,1249000,1191000,144000,1335000
2023,District of Oak Bay,05-1603-00,V8S 5C3,,978 LINKLEAS,1320000,1191000,295000,1486000
2023,District of Oak Bay,05-1604-00,V6H 1S1,,966 LINKLEAS,1231000,1192000,123000,1315000
2023,District of Oak Bay,05-1605-00,V8S 1Y1,,954 LINKLEAS,1258000,1192000,162000,1354000
2023,District of Oak Bay,05-1605-00,V8S 5C3,,954 LINKLEAS,1258000,1192000,162000,1354000
2023,District of Oak Bay,05-1605-00,V8S 5C3,,954 LINKLEAS,1258000,1192000,162000,1354000
2023,District of Oak Bay,05-1606-00,V5K 3M8,,942 LINKLEAS,1270000,1192000,164000,1356000
2023,District of Oak Bay,05-1607-00,V8S 5C3,,928 LINKLEAS,1276000,1192000,181000,1373000
2023,District of Oak Bay,05-1608-00,V8S 5C3,,910 LINKLEAS,1241000,1192000,137000,1329000
2023,District of Oak Bay,05-1609-00,V8S 5C3,,900 LINKLEAS,1249000,1192000,149000,1341000
2023,District of Oak Bay,05-1610-00,N2P 2L3,,888 LINKLEAS,1301000,1193000,191000,1384000
2023,District of Oak Bay,05-1611-00,V8S 5C3,,876 LINKLEAS,1248000,1193000,143000,1336000
2023,District of Oak Bay,05-1612-00,V8S 5C3,,856 LINKLEAS,1312000,1193000,219000,1412000
2023,District of Oak Bay,05-1613-00,V8S 5C3,,836 LINKLEAS,1364000,1193000,277000,1470000
2023,District of Oak Bay,05-1614-00,V8S 5C3,,834 LINKLEAS,1269000,1193000,167000,1360000
2023,District of Oak Bay,05-1615-00,V8S 5C3,,832 LINKLEAS,1337000,1193000,276000,1469000
2023,District of Oak Bay,05-1616-00,V8S 5C3,,820 LINKLEAS,1257000,1193000,154000,1347000
2023,District of Oak Bay,05-1617-00,V8S 5C3,,812 LINKLEAS,1183000,1193000,75000,1268000
2023,District of Oak Bay,05-1618-00,V8S 5C3,,798 LINKLEAS,1279000,1193000,180000,1373000
2023,District of Oak Bay,05-1619-00,V8S 5C3,,790 LINKLEAS,1460000,1193000,389000,1582000
2023,District of Oak Bay,05-1620-00,V8S 5C3,,782 LINKLEAS,2241000,1193000,1340000,2533000
2023,District of Oak Bay,05-1621-00,V8S 5C3,,770 LINKLEAS,2198000,1194000,1286000,2480000
2023,District of Oak Bay,05-1622-00,V8S 5C3,,760 LINKLEAS,1225000,1194000,117000,1311000
2023,District of Oak Bay,05-1623-00,V8S 5C3,,746 LINKLEAS,1254000,1194000,147000,1341000
2023,District of Oak Bay,05-1624-00,V8S 5C3,,736 LINKLEAS,1256000,1195000,150000,1345000
2023,District of Oak Bay,05-1625-00,V8S 5C3,,726 LINKLEAS,1332000,1193000,227000,1420000
2023,District of Oak Bay,05-1626-00,V0N 1P0,,714 LINKLEAS,1273000,1232000,148000,1380000
2023,District of Oak Bay,05-1627-00,V8S 2Z5,,2501 MCNEILL,1394000,1192000,315000,1507000
2023,District of Oak Bay,05-1628-00,V8S 5B1,,977 BYNG,1379000,1194000,294000,1488000
2023,District of Oak Bay,05-1629-00,V8S 5B1,,965 BYNG,1352000,1195000,257000,1452000
2023,District of Oak Bay,05-1630-00,V8S 5B1,,957 BYNG,1273000,1196000,168000,1364000
2023,District of Oak Bay,05-1631-00,V8W 1B1,,943 BYNG,1169900,1198000,60000,1258000
2023,District of Oak Bay,05-1632-00,V8S 5B1,,941 BYNG,1381000,1199000,287000,1486000
2023,District of Oak Bay,05-1633-00,V8S 5B1,,937 BYNG,1376000,1200000,266000,1466000
2023,District of Oak Bay,05-1633-00,V8S 5B1,,937 BYNG,1376000,1200000,266000,1466000
2023,District of Oak Bay,05-1634-00,V8S 5B1,,929 BYNG,1283000,1201000,173000,1374000
2023,District of Oak Bay,05-1635-00,V8S 5B1,,915 BYNG,1263000,1202000,150000,1352000
2023,District of Oak Bay,05-1635-00,V8S 5B1,,915 BYNG,1263000,1202000,150000,1352000
2023,District of Oak Bay,05-1636-00,V8S 5B1,,897 BYNG,1409000,1371000,144000,1515000
2023,District of Oak Bay,05-1640-00,V8S 5B1,,833 BYNG,1241000,1209000,135000,1344000
2023,District of Oak Bay,05-1641-00,V8S 5B1,,819 BYNG,1400000,1210000,299000,1509000
2023,District of Oak Bay,05-1642-00,V8S 5B1,,807 BYNG,1234000,1211000,113000,1324000
2023,District of Oak Bay,05-1643-00,V8S 5B1,,799 BYNG,1176400,1212000,55900,1267900
2023,District of Oak Bay,05-1644-00,V8S 5B1,,789 BYNG,1293000,1213000,171000,1384000
2023,District of Oak Bay,05-1645-00,V8S 5B1,,779 BYNG,1240000,1214000,113000,1327000
2023,District of Oak Bay,05-1646-00,V8S 5B1,,767 BYNG,2248000,1215000,1320000,2535000
2023,District of Oak Bay,05-1647-00,V8S 5B1,,759 BYNG,1305000,1216000,194000,1410000
2023,District of Oak Bay,05-1647-00,V8S 5B1,,759 BYNG,1305000,1216000,194000,1410000
2023,District of Oak Bay,05-1648-00,V8S 5B1,,749 BYNG,1312000,1217000,191000,1408000
2023,District of Oak Bay,05-1649-00,V8S 5B1,,735 BYNG,1523000,1218000,440000,1658000
2023,District of Oak Bay,05-1650-00,V8S 2T1,,2504 CENTRAL,2158000,1155000,1245000,2400000
2023,District of Oak Bay,05-1651-00,V8S 2T1,,2500 CENTRAL,1309000,1278000,119000,1397000
2023,District of Oak Bay,05-1651-00,V8S 2T1,,2500 CENTRAL,1309000,1278000,119000,1397000
2023,District of Oak Bay,05-1652-00,V8S 2T5,,2595 CENTRAL,1769000,1814000,290000,2104000
2023,District of Oak Bay,05-1653-00,V8S 5C6,,681 NEWPORT,1472000,1622000,176000,1798000
2023,District of Oak Bay,05-1654-00,V8S 5C6,,661 NEWPORT,4020000,2762000,2006000,4768000
2023,District of Oak Bay,05-1655-00,V8S 5C6,,641 NEWPORT,2190000,2462000,177000,2639000
2023,District of Oak Bay,05-1656-00,V8S 5C6,,621 NEWPORT,4432000,2619000,2430000,5049000
2023,District of Oak Bay,05-1657-00,V8S 4R6,,605 NEWPORT,3404000,2619000,1515000,4134000
2023,District of Oak Bay,05-1658-00,V8S 5C6,,575 NEWPORT,3052000,2619000,1012000,3631000
2023,District of Oak Bay,05-1659-00,V8S 5C6,,555 NEWPORT,2648000,2611000,557000,3168000
2023,District of Oak Bay,05-1660-00,V8S 5C6,,539 NEWPORT,5723000,3705000,2415000,6120000
2023,District of Oak Bay,05-1660-00,V8S 5C6,,539 NEWPORT,5723000,3705000,2415000,6120000
2023,District of Oak Bay,05-1661-00,V8W 1K8,,501 NEWPORT,6983000,3275000,4531000,7806000
2023,District of Oak Bay,05-1662-11,V8S 5C6,,475 NEWPORT,3707000,3523000,917000,4440000
2023,District of Oak Bay,05-1662-12,V8S 5C6,,451 NEWPORT,3879000,3515000,971000,4486000
2023,District of Oak Bay,05-1664-00,V8S 5C6,,407 NEWPORT,3299000,3029000,951000,3980000
2023,District of Oak Bay,05-1665-00,V8S 5C7,,686 NEWPORT,1464000,1610000,150000,1760000
2023,District of Oak Bay,05-1666-00,V6J 1C4,,2515 CENTRAL,1590000,1632000,267000,1899000
2023,District of Oak Bay,05-1667-00,V8S 5C2,,671 LINKLEAS,1372000,1513000,147000,1660000
2023,District of Oak Bay,05-1668-00,V8S 5C7,,670 NEWPORT,1720000,1649000,407000,2056000
2023,District of Oak Bay,05-1669-00,V9R 6V1,,655 LINKLEAS,1461000,1583000,171000,1754000
2023,District of Oak Bay,05-1669-00,V8L 3G3,,655 LINKLEAS,1461000,1583000,171000,1754000
2023,District of Oak Bay,05-1669-00,V8S 5C2,,655 LINKLEAS,1461000,1583000,171000,1754000
2023,District of Oak Bay,05-1671-00,V8S 5C7,,656 NEWPORT,1057400,1213000,68800,1281800
2023,District of Oak Bay,05-1672-00,V8S 5C7,,636 NEWPORT,2134000,1960000,614000,2574000
2023,District of Oak Bay,05-1673-00,V8S 5C7,,620 NEWPORT,2162000,2064000,550000,2614000
2023,District of Oak Bay,05-1674-00,V8S 5C7,,602 NEWPORT,2082000,2063000,439000,2502000
2023,District of Oak Bay,05-1675-00,V8S 5C2,,585 LINKLEAS,2163000,2304000,307000,2611000
2023,District of Oak Bay,05-1676-00,V8S 5C7,,572 NEWPORT,1757000,1767000,343000,2110000
2023,District of Oak Bay,05-1677-00,V8S 5C7,,556 NEWPORT,2650000,2064000,1116000,3180000
2023,District of Oak Bay,05-1678-00,V8S 5C7,,546 NEWPORT,1895000,2064000,223000,2287000
2023,District of Oak Bay,05-1679-00,V8S 5C7,,516 NEWPORT,2823000,2290000,957000,3247000
2023,District of Oak Bay,05-1680-00,V8S 5C1,,686 LINKLEAS,2002000,1916000,457000,2373000
2023,District of Oak Bay,05-1681-00,V8S 2T2,,2501 CENTRAL,1814000,1830000,354000,2184000
2023,District of Oak Bay,05-1681-00,V8S 2T2,,2501 CENTRAL,1814000,1830000,354000,2184000
2023,District of Oak Bay,05-1683-00,V8S 5C1,,670 LINKLEAS,2257000,1813000,864000,2677000
2023,District of Oak Bay,05-1686-00,V8S 5C1,,636 LINKLEAS,3921000,2359000,2175000,4534000
2023,District of Oak Bay,05-1688-00,V8S 5C1,,588 LINKLEAS,2465000,2343000,570000,2913000
2023,District of Oak Bay,05-1690-02,V8S 5C1,,572 LINKLEAS,5437000,3041000,3005000,6046000
2023,District of Oak Bay,05-1691-00,V8S 2T7,,535 ISLAND,2191000,2271000,364000,2635000
2023,District of Oak Bay,05-1693-00,V8S 2T6,,524 ISLAND,1907000,1841000,453000,2294000
2023,District of Oak Bay,05-1695-01,V8S 2T6,,520 ISLAND,2981000,2069000,1501000,3570000
2023,District of Oak Bay,05-1695-02,V8R 5X7,,520 ISLAND,6100,7400,0,7400
2023,District of Oak Bay,05-1696-01,V8S 2T6,,508 ISLAND,3731000,2908000,1479000,4387000
2023,District of Oak Bay,05-1696-02,V8S 5C5,,498 NEWPORT,4836000,2973000,2589000,5562000
2023,District of Oak Bay,05-1700-00,V8R 5N4,,380 NEWPORT,4023000,3319000,1534000,4853000
2023,District of Oak Bay,05-1701-00,V6R 4P2,,356 NEWPORT,2734000,3134000,200000,3334000
2023,District of Oak Bay,05-1705-02,V8S 2M7,,638 BEACH,3237000,2086000,1636000,3722000
2023,District of Oak Bay,05-1705-03,V8S 2M7,,644 BEACH,2886000,2569000,2335000,4904000
2023,District of Oak Bay,05-1705-04,V8V 3G7,,642 BEACH,2796000,2447000,1952000,4399000
2023,District of Oak Bay,05-1705-05,T6R 0C7,,640 BEACH,2104000,2557000,0,2557000
2023,District of Oak Bay,05-1706-00,V8S 5C5,,336 NEWPORT,3824000,2724000,3514000,6238000
2023,District of Oak Bay,05-1707-00,V8S 5C5,,318 NEWPORT,3235000,2865000,962000,3827000
2023,District of Oak Bay,05-1708-00,V8R 1G2,, INGLEWOOD,4400,4800,0,4800
2023,District of Oak Bay,05-1708-00,V8S 2T6,, INGLEWOOD,4400,4800,0,4800
2023,District of Oak Bay,05-1712-00,V8R 1G2,, ,44300,51000,0,51000
2023,District of Oak Bay,05-1713-00,V8S 5C7,,646 NEWPORT,1377000,1418000,220000,1638000
2023,District of Oak Bay,05-1714-00,V8R 2G9,,2185 FAIR,1217000,1150000,170000,1320000
2023,District of Oak Bay,05-1715-00,V8R 2G9,,2173 FAIR,1155000,1004000,264000,1268000
2023,District of Oak Bay,05-1716-00,V8R 2G9,,2169 FAIR,886000,897000,73600,970600
2023,District of Oak Bay,05-1716-00,V8R 2G9,,2169 FAIR,886000,897000,73600,970600
2023,District of Oak Bay,05-1717-00,V8R 2G9,,2165 FAIR,856300,864000,69100,933100
2023,District of Oak Bay,05-1718-00,V8R 2G9,,2161 FAIR,1568000,1301000,426000,1727000
2023,District of Oak Bay,05-1719-00,V8R 2G9,,2151 FAIR,1493000,1394000,242000,1636000
2023,District of Oak Bay,05-1720-00,V8S 4K3,,2147 FAIR,1456000,1350000,254000,1604000
2023,District of Oak Bay,05-1722-00,V8R 1Z5,,2361 CRANMORE,1414000,1223000,326000,1549000
2023,District of Oak Bay,05-1723-00,V8R 5T6,,1780 HAMPSHIRE,1169000,1104000,192000,1296000
2023,District of Oak Bay,05-1725-00,V8R 5T6,,1772 HAMPSHIRE,1442000,1312000,268000,1580000
2023,District of Oak Bay,05-1726-00,V8R 5T6,,1764 HAMPSHIRE,1820000,1312000,694000,2006000
2023,District of Oak Bay,05-1727-00,V8R 5T6,,1758 HAMPSHIRE,1608000,1312000,471000,1783000
2023,District of Oak Bay,05-1728-00,V8R 5T6,,1750 HAMPSHIRE,1839000,1312000,740000,2052000
2023,District of Oak Bay,05-1729-00,V8R 5T6,,1742 HAMPSHIRE,1796000,1312000,642000,1954000
2023,District of Oak Bay,05-1730-00,V8R 5T6,,1736 HAMPSHIRE,2249000,1312000,1248000,2560000
2023,District of Oak Bay,05-1731-00,V8R 5T6,,1728 HAMPSHIRE,1864000,1312000,768000,2080000
2023,District of Oak Bay,05-1732-00,V8R 1G2,, DOWNES,1274000,1472000,0,1472000
2023,District of Oak Bay,05-1733-00,K1M 2B3,,1714 HAMPSHIRE,1321000,1242000,224000,1466000
2023,District of Oak Bay,05-1734-00,V8R 1G2,,1708 HAMPSHIRE,1051000,1142000,0,1142000
2023,District of Oak Bay,05-1735-00,V8R 1Z5,,2345 CRANMORE,3164000,1531000,2056000,3587000
2023,District of Oak Bay,05-1736-01,V8S 3E1,,2264 WINDSOR,1967000,1095000,1114000,2209000
2023,District of Oak Bay,05-1736-02,V8X 5H1,, WINDSOR,1024000,1095000,312000,1407000
2023,District of Oak Bay,05-1737-00,V8X 5H1,,2268 WINDSOR,1024000,1095000,386000,1481000
2023,District of Oak Bay,05-1738-01,V8S 3E1,,2276 WINDSOR,1292000,1095000,290000,1385000
2023,District of Oak Bay,05-1738-02,V8S 3E1,,2288 WINDSOR,1296000,1095000,285000,1380000
2023,District of Oak Bay,05-1739-00,V8S 4W9,,1130 OLIVER,1644000,1095000,700000,1795000
2023,District of Oak Bay,05-1740-00,V8S 4W9,,1146 OLIVER,1360000,1308000,157000,1465000
2023,District of Oak Bay,05-1741-00,V8S 4W9,,1158 OLIVER,1508000,1308000,308000,1616000
2023,District of Oak Bay,05-1742-00,V8S 4W9,,1180 OLIVER,1461000,1308000,258000,1566000
2023,District of Oak Bay,05-1743-00,V8S 4W9,,1182 OLIVER,1344000,1308000,136000,1444000
2023,District of Oak Bay,05-1744-00,V8S 4W9,,1196 OLIVER,1565000,1308000,392000,1700000
2023,District of Oak Bay,05-1745-01,V8S 4W9,,1208 OLIVER,2923000,1705000,1424000,3129000
2023,District of Oak Bay,05-1746-00,V8S 4V7,,1225 MONTEREY,1360000,1272000,196000,1468000
2023,District of Oak Bay,05-1747-00,V8S 4V7,,1217 MONTEREY,1329000,1272000,162000,1434000
2023,District of Oak Bay,05-1748-00,V8S 4V7,,1199 MONTEREY,1217800,1271000,36400,1307400
2023,District of Oak Bay,05-1749-00,V8S 4V7,,1179 MONTEREY,1299000,1271000,141000,1412000
2023,District of Oak Bay,05-1750-00,V8S 4V7,,1161 MONTEREY,1387000,1271000,225000,1496000
2023,District of Oak Bay,05-1751-01,V8S 4V7,,1159 MONTEREY,1467000,1271000,308000,1579000
2023,District of Oak Bay,05-1751-02,V8S 4V7,,1151 MONTEREY,1526000,1271000,359000,1630000
2023,District of Oak Bay,05-1752-00,V8S 2P2,,2197 LAFAYETTE,2388000,1302000,1408000,2710000
2023,District of Oak Bay,05-1754-00,V8S 2P2,,2183 LAFAYETTE,1376000,847000,654000,1501000
2023,District of Oak Bay,05-1755-00,V8S 2P2,,2177 LAFAYETTE,1362000,1304000,160000,1464000
2023,District of Oak Bay,05-1756-00,V8S 2P2,,2171 LAFAYETTE,1285000,1214000,162000,1376000
2023,District of Oak Bay,05-1757-00,V8S 2P2,,2167 LAFAYETTE,1468000,1214000,376000,1590000
2023,District of Oak Bay,05-1758-00,V8S 4M7,,455 VICTORIA,1430000,1260000,291000,1551000
2023,District of Oak Bay,05-1759-00,V8S 4M7,,465 VICTORIA,1227900,1260000,59700,1319700
2023,District of Oak Bay,05-1760-00,V8S 4M8,,495 VICTORIA,1602000,1166000,594000,1760000
2023,District of Oak Bay,05-1761-00,V8S 4M8,,507 VICTORIA,1804000,1166000,771000,1937000
2023,District of Oak Bay,05-1762-00,V8S 2P1,,2162 LAFAYETTE,1282000,1166000,214000,1380000
2023,District of Oak Bay,05-1763-00,V8S 2P1,,2170 LAFAYETTE,1379000,1166000,333000,1499000
2023,District of Oak Bay,05-1764-00,V8S 2P1,,2172 LAFAYETTE,1458000,1214000,361000,1575000
2023,District of Oak Bay,05-1764-00,V8S 2P1,,2172 LAFAYETTE,1458000,1214000,361000,1575000
2023,District of Oak Bay,05-1765-00,V8S 2P1,,2178 LAFAYETTE,1184800,1214000,57000,1271000
2023,District of Oak Bay,05-1765-00,V8S 2P1,,2178 LAFAYETTE,1184800,1214000,57000,1271000
2023,District of Oak Bay,05-1766-00,V8W 0B8,,2184 LAFAYETTE,1917000,1366000,1316000,2682000
2023,District of Oak Bay,05-1767-00,V8S 2P1,,2196 LAFAYETTE,1743000,1374000,520000,1894000
2023,District of Oak Bay,05-1769-00,V8R 5T7,,1729 HAMPSHIRE,1449000,1398000,207000,1605000
2023,District of Oak Bay,05-1770-00,V8R 5T7,,1737 HAMPSHIRE,1902000,1459000,641000,2100000
2023,District of Oak Bay,05-1771-00,V8R 5T7,,1743 HAMPSHIRE,1587000,1462000,303000,1765000
2023,District of Oak Bay,05-1772-00,V8R 5T7,,1751 HAMPSHIRE,1563000,1465000,234000,1699000
2023,District of Oak Bay,05-1773-00,V8R 5T7,,1759 HAMPSHIRE,1670000,1468000,363000,1831000
2023,District of Oak Bay,05-1774-00,V8R 5T7,,1767 HAMPSHIRE,1802000,1470000,529000,1999000
2023,District of Oak Bay,05-1775-00,V8R 5T7,,1777 HAMPSHIRE,1787000,1663000,292000,1955000
2023,District of Oak Bay,05-1776-00,V8P 2L5,,1781 HAMPSHIRE,1471000,1307000,297000,1604000
2023,District of Oak Bay,05-1777-00,V8R 1Z6,,2425 CRANMORE,1360000,1228000,265000,1493000
2023,District of Oak Bay,05-1777-00,V8R 1Z6,,2425 CRANMORE,1360000,1228000,265000,1493000
2023,District of Oak Bay,05-1778-00,V8R 1Z6,,2439 CRANMORE,1276000,1236000,179000,1415000
2023,District of Oak Bay,05-1778-00,V8R 1Z6,,2439 CRANMORE,1276000,1236000,179000,1415000
2023,District of Oak Bay,05-1779-00,V8R 1Z6,,2449 CRANMORE,1229100,1228000,122000,1350000
2023,District of Oak Bay,05-1780-00,V8R 1Z6,,2465 CRANMORE,1244000,1225000,144000,1369000
2023,District of Oak Bay,05-1781-00,V8R 1Z6,,2483 CRANMORE,1532000,1226000,454000,1680000
2023,District of Oak Bay,05-1782-00,V8R 5V8,,1778 ST. ANN,1210000,1182000,125000,1307000
2023,District of Oak Bay,05-1783-00,V8R 5V8,,1770 ST. ANN,1221000,1181000,162000,1343000
2023,District of Oak Bay,05-1784-00,V8R 5V8,,1766 ST. ANN,1207000,1181000,150000,1331000
2023,District of Oak Bay,05-1785-00,V8R 5V8,,1754 ST. ANN,1221000,1180000,146000,1326000
2023,District of Oak Bay,05-1786-00,V8R 5V8,,1750 ST. ANN,1219000,1180000,145000,1325000
2023,District of Oak Bay,05-1787-00,V8R 5V8,,1744 ST. ANN,1199000,1180000,144000,1324000
2023,District of Oak Bay,05-1788-00,V8R 5V8,,1736 ST. ANN,1537000,1374000,300000,1674000
2023,District of Oak Bay,05-1788-00,V8R 5V8,,1736 ST. ANN,1537000,1374000,300000,1674000
2023,District of Oak Bay,05-1789-00,V8R 5V8,,1724 ST. ANN,1471000,1379000,198000,1577000
2023,District of Oak Bay,05-1790-01,V8R 5V8,,1718 ST. ANN,1472000,1178000,439000,1617000
2023,District of Oak Bay,05-1790-02,V8R 5V8,,1712 ST. ANN,1354000,1118000,369000,1487000
2023,District of Oak Bay,05-1791-00,V8R 5V8,,1704 ST. ANN,1077600,1118000,62300,1180300
2023,District of Oak Bay,05-1792-00,V8R 1G2,, ST. ANN,845000,972000,0,972000
2023,District of Oak Bay,05-1793-00,V8V 3K5,,2511 CRANMORE,1429000,1136000,442000,1578000
2023,District of Oak Bay,05-1794-00,V8R 1Z8,,2519 CRANMORE,1284000,1136000,256000,1392000
2023,District of Oak Bay,05-1795-00,V8R 1Z8,,2525 CRANMORE,1267000,1136000,258000,1394000
2023,District of Oak Bay,05-1796-00,V8R 1Z8,,2535 CRANMORE,1352000,1136000,343000,1479000
2023,District of Oak Bay,05-1797-00,V8R 1Z8,,2541 CRANMORE,1307000,1180000,255000,1435000
2023,District of Oak Bay,05-1800-00,V8R 5V7,,1757 ST. ANN,1244000,1202000,173000,1375000
2023,District of Oak Bay,05-1801-00,V8R 5V7,,1749 ST. ANN,1429000,1285000,272000,1557000
2023,District of Oak Bay,05-1802-00,V8R 5W6,,1764 LULIE,1368000,1239000,252000,1491000
2023,District of Oak Bay,05-1803-00,V8R 5W6,,1756 LULIE,1362000,1239000,202000,1441000
2023,District of Oak Bay,05-1804-00,V8R 5W6,,1746 LULIE,1282000,1238000,186000,1424000
2023,District of Oak Bay,05-1805-00,V8R 5W6,,1734 LULIE,1442000,1238000,336000,1574000
2023,District of Oak Bay,05-1806-00,V8R 5W6,,1724 LULIE,1353000,1269000,204000,1473000
2023,District of Oak Bay,05-1807-00,V8R 1G2,, MONTEREY,695000,812000,0,812000
2023,District of Oak Bay,05-1807-00,V8R 1G2,, MONTEREY,695000,812000,0,812000
2023,District of Oak Bay,05-1808-00,V8R 1Z9,,2559 CRANMORE,1490000,1132000,495000,1627000
2023,District of Oak Bay,05-1809-00,V8R 1Z9,,2569 CRANMORE,1151000,1123000,126000,1249000
2023,District of Oak Bay,05-1810-00,V8R 1Z9,,2575 CRANMORE,1313000,1123000,311000,1434000
2023,District of Oak Bay,05-1812-01,V8R 1Z9,,2585 CRANMORE,2218000,1123000,1394000,2517000
2023,District of Oak Bay,05-1812-02,V8R 1Z9,,2595 CRANMORE,1956000,1204000,1009000,2213000
2023,District of Oak Bay,05-1813-00,V8R 5W7,,1765 LULIE,1288000,1234000,166000,1400000
2023,District of Oak Bay,05-1814-00,V8R 5W7,,1755 LULIE,1207000,1148000,168000,1316000
2023,District of Oak Bay,05-1816-00,V8R 1G2,, MONTEREY,449000,519000,0,519000
2023,District of Oak Bay,05-1817-00,V8R 1G2,, MONTEREY,331000,386000,0,386000
2023,District of Oak Bay,05-1818-00,V8R 5W7,,1745 LULIE,1430000,1272000,279000,1551000
2023,District of Oak Bay,05-1822-00,V8R 2A1,,2615 CRANMORE,1568000,1450000,266000,1716000
2023,District of Oak Bay,05-1822-00,V8R 2A1,,2615 CRANMORE,1568000,1450000,266000,1716000
2023,District of Oak Bay,05-1823-00,V8R 2A1,,2635 CRANMORE,1487000,1461000,157000,1618000
2023,District of Oak Bay,05-1823-00,V8R 2A1,,2635 CRANMORE,1487000,1461000,157000,1618000
2023,District of Oak Bay,05-1824-00,V8R 1G2,, MONTEITH,792000,917000,0,917000
2023,District of Oak Bay,05-1825-00,V8R 1G2,, MONTEITH,803000,929000,0,929000
2023,District of Oak Bay,05-1826-00,V8R 1G2,, MONTEITH,803000,929000,0,929000
2023,District of Oak Bay,05-1828-00,V8R 5X4,,1733 MONTEITH,2003000,1768000,440000,2208000
2023,District of Oak Bay,05-1829-00,V8R 5X4,,1725 MONTEITH,1865000,1610000,432000,2042000
2023,District of Oak Bay,05-1830-00,V6J 3K8,,1715 MONTEITH,1924000,1618000,688000,2306000
2023,District of Oak Bay,05-1831-00,V8R 1G2,,1703 MONTEREY,1498000,1328000,350000,1678000
2023,District of Oak Bay,05-1831-00,V8R 1G2,,1703 MONTEREY,1498000,1328000,350000,1678000
2023,District of Oak Bay,05-1831-00,V8R 1G2,,1703 MONTEREY,1498000,1328000,350000,1678000
2023,District of Oak Bay,05-1833-00,V8R 1G2,, MONTEREY,739000,860000,0,860000
2023,District of Oak Bay,05-1837-00,V8R 1G2,, MONTEREY,891000,1033000,0,1033000
2023,District of Oak Bay,05-1838-00,V8R 1G2,, MONTEREY,907000,1050000,0,1050000
2023,District of Oak Bay,05-1839-00,V8R 1G2,, MONTEREY,922000,1062000,0,1062000
2023,District of Oak Bay,05-1840-00,V8R 1G2,, MONTEREY,933000,1076000,0,1076000
2023,District of Oak Bay,05-1841-00,V8R 1G2,, MONTEREY,537000,626000,0,626000
2023,District of Oak Bay,05-1842-00,V8R 1G2,, MONTEREY,545000,636000,0,636000
2023,District of Oak Bay,05-1843-00,V8R 1G2,, MONTEREY,671000,784000,0,784000
2023,District of Oak Bay,05-1844-00,V8R 5X3,,1718 MONTEITH,1670000,1431000,376000,1807000
2023,District of Oak Bay,05-1845-00,V8R 5X3,,1712 MONTEITH,1649000,1374000,419000,1793000
2023,District of Oak Bay,05-1846-00,V8R 5X3,,1704 MONTEITH,1653000,1309000,518000,1827000
2023,District of Oak Bay,05-1847-10,V8S 5A3,,1234 TRANSIT,2372000,1559000,1019000,2578000
2023,District of Oak Bay,05-1847-20,V8S 5A3,,1230 TRANSIT,2517000,1451000,1363000,2814000
2023,District of Oak Bay,05-1849-00,V8R 1W9,,1220 TRANSIT,2360000,1859000,725000,2584000
2023,District of Oak Bay,05-1849-00,V8R 1W9,,1220 TRANSIT,2360000,1859000,725000,2584000
2023,District of Oak Bay,05-1851-00,V8S 5A3,,1182 TRANSIT,1532000,1433000,221000,1654000
2023,District of Oak Bay,05-1852-00,V8S 5A3,,1166 TRANSIT,1506000,1433000,183000,1616000
2023,District of Oak Bay,05-1853-00,V8S 3E7,,2390 WINDSOR,1404000,1364000,143000,1507000
2023,District of Oak Bay,05-1854-00,V8S 3E7,,2380 WINDSOR,2485000,1364000,1396000,2760000
2023,District of Oak Bay,05-1855-00,V8S 3E7,,2370 WINDSOR,1327400,1364000,71100,1435100
2023,District of Oak Bay,05-1856-00,V8S 4Z1,,1151 ST. DAVID,1648000,1449000,333000,1782000
2023,District of Oak Bay,05-1857-00,V8S 4Z1,,1207 ST. DAVID,1629000,1447000,316000,1763000
2023,District of Oak Bay,05-1858-00,V8S 4Z1,,1219 ST. DAVID,1650000,1433000,343000,1776000
2023,District of Oak Bay,05-1862-00,V8S 4L2,,374 SUNSET,3248000,1759000,2144000,3903000
2023,District of Oak Bay,05-1863-00,V8S 4L2,,388 SUNSET,2066000,1704000,720000,2424000
2023,District of Oak Bay,05-1864-00,V8S 2L6,,189 BEACH,1533000,1487000,356000,1843000
2023,District of Oak Bay,05-1865-00,V8S 4L3,,363 SUNSET,1867000,1434000,771000,2205000
2023,District of Oak Bay,05-1866-00,V8S 4L3,,369 SUNSET,1452000,1434000,302000,1736000
2023,District of Oak Bay,05-1867-00,V8S 4L3,,375 SUNSET,1610000,1434000,472000,1906000
2023,District of Oak Bay,05-1868-00,V8S 4L3,,383 SUNSET,1419000,1434000,257000,1691000
2023,District of Oak Bay,05-1869-00,V8S 4L3,,389 SUNSET,1514000,1434000,359000,1793000
2023,District of Oak Bay,05-1870-00,V8S 2L8,,193 BEACH,1451000,1487000,259000,1746000
2023,District of Oak Bay,05-1871-00,V8S 2K3,,362 KING GEORGE,2521000,1560000,1445000,3005000
2023,District of Oak Bay,05-1871-00,V8S 2K3,,362 KING GEORGE,2521000,1560000,1445000,3005000
2023,District of Oak Bay,05-1872-00,V8S 2K3,,368 KING GEORGE,1137200,1288000,82800,1370800
2023,District of Oak Bay,05-1872-01,V8S 5C5,,376 KING GEORGE,2315000,1434000,1297000,2731000
2023,District of Oak Bay,05-1873-00,V8S 2K3,,380 KING GEORGE,1864000,1434000,825000,2259000
2023,District of Oak Bay,05-1874-00,V8S 2K3,,388 KING GEORGE,1611000,1434000,863000,2297000
2023,District of Oak Bay,05-1875-00,V8S 2K3,,396 KING GEORGE,1640000,1487000,493000,1980000
2023,District of Oak Bay,05-1879-00,V8S 2J8,,383 KING GEORGE,4716000,2410000,2309000,4719000
2023,District of Oak Bay,05-1880-10,V8S 2J8,,389 KING GEORGE,4019000,2417000,1489000,3906000
2023,District of Oak Bay,05-1881-00,V8S 2J8,,395 KING GEORGE,2878000,2535000,155000,2690000
2023,District of Oak Bay,05-1883-00,V8S 2N5,,1318 BEACH,6083000,3091000,3609000,6700000
2023,District of Oak Bay,05-1883-00,V8S 2N5,,1318 BEACH,6083000,3091000,3609000,6700000
2023,District of Oak Bay,05-1884-00,V8R 6L9,,2675 CURRIE,1377000,1204000,265000,1469000
2023,District of Oak Bay,05-1885-00,V8S 3B9,,2659 CURRIE,1663000,1403000,417000,1820000
2023,District of Oak Bay,05-1886-00,V8S 3B9,,2651 CURRIE,1422000,1403000,134000,1537000
2023,District of Oak Bay,05-1887-00,V8S 3B9,,2639 CURRIE,1780000,1488000,438000,1926000
2023,District of Oak Bay,05-1887-00,V8S 3B9,,2639 CURRIE,1780000,1488000,438000,1926000
2023,District of Oak Bay,05-1888-00,V8S 3B9,,2629 CURRIE,1712000,1248000,627000,1875000
2023,District of Oak Bay,05-1890-00,V8S 5E5,,1107 NEWPORT,1377900,1391000,93800,1484800
2023,District of Oak Bay,05-1891-00,V8S 3B3,,2616 ORCHARD,1476000,1351000,243000,1594000
2023,District of Oak Bay,05-1892-00,V8S 3B3,,2630 ORCHARD,1962000,1391000,1598000,2989000
2023,District of Oak Bay,05-1893-00,V8S 3B3,,2648 ORCHARD,1591000,1391000,328000,1719000
2023,District of Oak Bay,05-1894-00,V8S 3B3,,2664 ORCHARD,1617000,1391000,365000,1756000
2023,District of Oak Bay,05-1895-00,V8S 3B3,,2674 ORCHARD,1271100,1258000,106000,1364000
2023,District of Oak Bay,05-1903-00,V8P 4G8,,2660 CURRIE,3489000,2690000,1151000,3841000
2023,District of Oak Bay,05-1903-00,V8P 4G8,,2660 CURRIE,3489000,2690000,1151000,3841000
2023,District of Oak Bay,05-1905-00,V9B 0A6,,1336 BEACH,2237000,1916000,604000,2520000
2023,District of Oak Bay,05-1906-00,V9B 0G9,,1344 BEACH,2305000,1295000,1244000,2539000
2023,District of Oak Bay,05-1912-00,V8P 1P3,,1161 NEWPORT,1253100,1165000,301200,1466200
2023,District of Oak Bay,05-1913-00,V8W 1G2,,1157 NEWPORT,1108100,971000,467000,1438000
2023,District of Oak Bay,05-1914-00,V8S 2N4,,1147 NEWPORT,2264000,1138000,1354000,2492000
2023,District of Oak Bay,05-1915-00,V8N 1X6,,2620 CURRIE,1811000,1068000,1464000,2532000
2023,District of Oak Bay,05-1919-00,V6B 4M9,,1400 BEACH,5034000,2530000,3008000,5538000
2023,District of Oak Bay,05-1919-00,V6B 4M9,,1400 BEACH,5034000,2530000,3008000,5538000
2023,District of Oak Bay,05-1921-00,V8R 6E8,,580 BEACH,2464000,2058000,711000,2769000
2023,District of Oak Bay,05-1922-00,V8S 2M5,,572 BEACH,2676000,2058000,1084000,3142000
2023,District of Oak Bay,05-1923-00,T3Z 2Z5,,568 BEACH,2418000,2057000,642000,2699000
2023,District of Oak Bay,05-1923-05,V8S 2M5,,564 BEACH,2186000,2057000,497000,2554000
2023,District of Oak Bay,05-1925-00,V8S 2M5,,560 BEACH,1641000,1633000,262000,1895000
2023,District of Oak Bay,05-1925-01,V8S 2M5,,562 BEACH,2114000,1627000,835000,2462000
2023,District of Oak Bay,05-1926-00,V8S 2M5,,554 BEACH,2425000,2056000,789000,2845000
2023,District of Oak Bay,05-1927-00,V8S 2M5,,550 BEACH,2020000,2053000,303000,2356000
2023,District of Oak Bay,05-1928-00,V8S 2M5,,548 BEACH,1969000,2055000,244000,2299000
2023,District of Oak Bay,05-1932-00,V8S 2M5,,526 BEACH,4110000,1957000,2547000,4504000
2023,District of Oak Bay,05-1933-00,V8S 2M5,,522 BEACH,1878100,2166000,44200,2210200
2023,District of Oak Bay,05-1934-00,V8S 2M5,,518 BEACH,2705000,2357000,833000,3190000
2023,District of Oak Bay,05-1935-00,V8S 2M5,,514 BEACH,2053000,2088000,303000,2391000
2023,District of Oak Bay,05-1937-00,,,504 BEACH,1907000,1876000,328000,2204000
2023,District of Oak Bay,05-1938-00,V8S 2M5,,500 BEACH,2696000,1784000,1378000,3162000
2023,District of Oak Bay,05-1939-00,V8R 1G2,, ISLAND,3926000,4531000,0,4531000
2023,District of Oak Bay,05-1939-00,V9T 6J9,, ISLAND,3926000,4531000,0,4531000
2023,District of Oak Bay,05-1940-00,V9T 6J9,, ISLAND,1162000,1344000,0,1344000
2023,District of Oak Bay,05-1940-00,V8R 1G2,, ISLAND,1162000,1344000,0,1344000
2023,District of Oak Bay,06-1942-00,V8R 6T4,,235 DENISON,2634000,2635000,549000,3184000
2023,District of Oak Bay,06-1943-00,V8S 4K2,,223 DENISON,2680000,2645000,554000,3199000
2023,District of Oak Bay,06-1946-50,V8S 2K6,,151 SUNNY,2611000,2628000,498000,3126000
2023,District of Oak Bay,06-1948-00,V8R 1G2,, DENISON,39000,44900,0,44900
2023,District of Oak Bay,06-1949-00,V8R 1G2,, DENISON,1490000,1734000,0,1734000
2023,District of Oak Bay,06-1951-00,V6Z 0B9,, DENISON,24000,27600,0,27600
2023,District of Oak Bay,06-1951-01,V8R 1G2,, DENISON,1515000,1763000,0,1763000
2023,District of Oak Bay,06-1951-02,V8R 1G2,, DENISON,437000,634000,0,634000
2023,District of Oak Bay,06-1951-03,V8R 1G2,, DENISON,1397000,1614000,0,1614000
2023,District of Oak Bay,06-1951-04,V8R 1G2,, DENISON,79800,92400,0,92400
2023,District of Oak Bay,06-1951-05,V8R 1G2,, DENISON,426000,492000,0,492000
2023,District of Oak Bay,06-1953-00,V8S 2J8,,261 KING GEORGE,5356000,4021000,978000,4999000
2023,District of Oak Bay,06-1956-10,V8S 2K5,,180 PRINCE ANDREW,3500000,2173000,2063000,4236000
2023,District of Oak Bay,06-1956-20,V8S 2K2,,230 KING GEORGE,2098000,1993000,540000,2533000
2023,District of Oak Bay,06-1956-30,V8S 2K2,,200 KING GEORGE,2157000,2172000,439000,2611000
2023,District of Oak Bay,06-1959-00,V8S 2K2,,260 KING GEORGE,2457000,2567000,382000,2949000
2023,District of Oak Bay,06-1960-00,V8S 2K2,,310 KING GEORGE,2160000,2314000,276000,2590000
2023,District of Oak Bay,06-1962-00,V8S 4H9,,921 FOUL BAY,3672000,2488000,1349000,3837000
2023,District of Oak Bay,06-1963-00,V8S 4H9,,949 FOUL BAY,1378000,1155000,328000,1483000
2023,District of Oak Bay,06-1964-00,V8S 4H9,,947 FOUL BAY,1338000,1185000,259000,1444000
2023,District of Oak Bay,06-1965-00,V8S 4H9,,935 FOUL BAY,4261000,3009000,1536000,4545000
2023,District of Oak Bay,06-1966-00,V8S 4P3,,1255 VICTORIA,2622000,1704000,1118000,2822000
2023,District of Oak Bay,06-1966-00,V8S 4P3,,1255 VICTORIA,2622000,1704000,1118000,2822000
2023,District of Oak Bay,06-1967-00,V8S 4P3,,1253 VICTORIA,1581000,1416000,293000,1709000
2023,District of Oak Bay,06-1968-00,V8S 4P3,,1251 VICTORIA,1500000,1410000,232000,1642000
2023,District of Oak Bay,06-1969-00,V8S 4P3,,1251 VICTORIA,1309000,1403000,0,1403000
2023,District of Oak Bay,06-1970-10,V8S 4P3,,1231 VICTORIA,2619000,1396000,1504000,2900000
2023,District of Oak Bay,06-1970-20,V8S 4P3,,1221 VICTORIA,2619000,1389000,1508000,2897000
2023,District of Oak Bay,06-1971-00,V8S 4P3,,1199 VICTORIA,1820000,1382000,598000,1980000
2023,District of Oak Bay,06-1972-00,V8S 4P3,,1187 VICTORIA,1703000,1373000,486000,1859000
2023,District of Oak Bay,06-1975-00,V8S 4R6,,1286 ROSLYN,1821000,1608000,352000,1960000
2023,District of Oak Bay,06-1976-00,V8S 4R6,,1262 ROSLYN,1383000,1317000,167000,1484000
2023,District of Oak Bay,06-1977-00,V8S 4R6,,1252 ROSLYN,1439000,1317000,239000,1556000
2023,District of Oak Bay,06-1978-01,V8S 4R6,,1226 ROSLYN,1889000,1336000,726000,2062000
2023,District of Oak Bay,06-1978-02,V8S 4R6,,1220 ROSLYN,2374000,1298000,1326000,2624000
2023,District of Oak Bay,06-1979-00,V8S 4R6,,1214 ROSLYN,1561000,1317000,372000,1689000
2023,District of Oak Bay,06-1980-00,V8S 4R6,,1198 ROSLYN,1376000,1317000,164000,1481000
2023,District of Oak Bay,06-1981-00,V8S 4R6,,1188 ROSLYN,1501000,1317000,300000,1617000
2023,District of Oak Bay,06-1982-00,V8S 4R6,,1176 ROSLYN,1441000,1317000,266000,1583000
2023,District of Oak Bay,06-1983-00,V8S 4R6,,1164 ROSLYN,1647000,1317000,456000,1773000
2023,District of Oak Bay,06-1984-00,V8S 4R6,,1150 ROSLYN,1613000,1317000,430000,1747000
2023,District of Oak Bay,06-1985-00,V8P 4P5,,1145 VICTORIA,1319000,1244000,171000,1415000
2023,District of Oak Bay,06-1986-00,V8S 3C5,,2138 WINDSOR,1430000,1196000,363000,1559000
2023,District of Oak Bay,06-1986-00,V8S 3C5,,2138 WINDSOR,1430000,1196000,363000,1559000
2023,District of Oak Bay,06-1987-00,V8S 3C5,,2146 WINDSOR,1353000,1156000,300000,1456000
2023,District of Oak Bay,06-1988-00,V8S 3C5,,2150 WINDSOR,1289000,1176000,204000,1380000
2023,District of Oak Bay,06-1989-00,V8S 3C5,,2154 WINDSOR,1370000,1176000,301000,1477000
2023,District of Oak Bay,06-1990-00,V8S 3C5,,2160 WINDSOR,1505000,1176000,472000,1648000
2023,District of Oak Bay,06-1991-00,V8S 4R7,,1275 ROSLYN,1910000,1580000,487000,2067000
2023,District of Oak Bay,06-1991-00,V8S 4R7,,1275 ROSLYN,1910000,1580000,487000,2067000
2023,District of Oak Bay,06-1992-00,T2S 0V8,,1265 ROSLYN,1446000,1262000,298000,1560000
2023,District of Oak Bay,06-1993-00,V8S 4R7,,1251 ROSLYN,1720000,1262000,641000,1903000
2023,District of Oak Bay,06-1994-00,V8S 4R7,,1235 ROSLYN,1457000,1262000,324000,1586000
2023,District of Oak Bay,06-1995-00,V8S 4R7,,1225 ROSLYN,1610000,1262000,489000,1751000
2023,District of Oak Bay,06-1996-00,V8S 4R7,,1213 ROSLYN,1252300,1262000,86100,1348100
2023,District of Oak Bay,06-1997-00,V8S 4R7,,1201 ROSLYN,1472000,1262000,333000,1595000
2023,District of Oak Bay,06-1998-00,V8S 4R7,,1189 ROSLYN,1292000,1262000,144000,1406000
2023,District of Oak Bay,06-1999-00,V8S 4R7,,1177 ROSLYN,1293000,1262000,140000,1402000
2023,District of Oak Bay,06-2000-00,V8S 4R7,,1165 ROSLYN,1454000,1262000,308000,1570000
2023,District of Oak Bay,06-2001-00,V8S 4R7,,1151 ROSLYN,1486000,1262000,349000,1611000
2023,District of Oak Bay,06-2002-05,V8S 4T2,,1288 HAMPSHIRE,1204000,1142000,145000,1287000
2023,District of Oak Bay,06-2002-10,,,1280 HAMPSHIRE,1341000,1202000,241000,1443000
2023,District of Oak Bay,06-2003-00,V8S 4T2,,1262 HAMPSHIRE,1574000,1368000,310000,1678000
2023,District of Oak Bay,06-2004-00,V8S 4T2,,1238 HAMPSHIRE,1397200,1439000,70800,1509800
2023,District of Oak Bay,06-2005-00,V8S 4T2,,1226 HAMPSHIRE,1285000,1202000,202000,1404000
2023,District of Oak Bay,06-2006-00,M4V 2Y8,,1214 HAMPSHIRE,1750000,1202000,676000,1878000
2023,District of Oak Bay,06-2007-00,V8M 1M6,,1200 HAMPSHIRE,1293000,1202000,188000,1390000
2023,District of Oak Bay,06-2008-00,V8S 4T2,,1188 HAMPSHIRE,1439000,1202000,357000,1559000
2023,District of Oak Bay,06-2009-00,V8S 4T2,,1176 HAMPSHIRE,1390600,1404000,96000,1500000
2023,District of Oak Bay,06-2010-00,V8S 4T2,,1162 HAMPSHIRE,1768000,1404000,517000,1921000
2023,District of Oak Bay,06-2011-01,V8S 4R7,,1101 ROSLYN,1601000,1215000,531000,1746000
2023,District of Oak Bay,06-2011-02,V8S 3C6,,2176 WINDSOR,1587000,1215000,493000,1708000
2023,District of Oak Bay,06-2012-00,,,2184 WINDSOR,1855000,1216000,796000,2012000
2023,District of Oak Bay,06-2015-00,V8S 4T1,,1289 HAMPSHIRE,1480000,1331000,274000,1605000
2023,District of Oak Bay,06-2016-00,V8S 4T1,,1273 HAMPSHIRE,1467000,1331000,282000,1613000
2023,District of Oak Bay,06-2017-00,V8S 2E9,,2227 BRIGHTON,1603000,1186000,581000,1767000
2023,District of Oak Bay,06-2018-00,V8S 2E9,,2233 BRIGHTON,1814000,1191000,825000,2016000
2023,District of Oak Bay,06-2019-00,V8S 2E9,,2241 BRIGHTON,1285000,1197000,183000,1380000
2023,District of Oak Bay,06-2020-00,V8S 2E9,,2245 BRIGHTON,2346000,1201000,1413000,2614000
2023,District of Oak Bay,06-2021-00,V8S 2E9,,2253 BRIGHTON,1562000,1220000,465000,1685000
2023,District of Oak Bay,06-2022-00,V8S 4T1,,1257 HAMPSHIRE,2273000,1419000,1120000,2539000
2023,District of Oak Bay,06-2023-00,V8S 4T1,,1241 HAMPSHIRE,1400600,1419000,92300,1511300
2023,District of Oak Bay,06-2024-00,V8S 4T1,,1225 HAMPSHIRE,1532000,1419000,226000,1645000
2023,District of Oak Bay,06-2025-00,V8S 4T1,,1221 HAMPSHIRE,1792000,1419000,551000,1970000
2023,District of Oak Bay,06-2026-00,V8S 4T1,,1211 HAMPSHIRE,1458000,1419000,167000,1586000
2023,District of Oak Bay,06-2027-00,V8S 4T1,,1199 HAMPSHIRE,1471000,1419000,160000,1579000
2023,District of Oak Bay,06-2028-00,V8S 4T1,,1187 HAMPSHIRE,1373600,1419000,60600,1479600
2023,District of Oak Bay,06-2029-00,V8S 4T1,,1175 HAMPSHIRE,1659000,1419000,379000,1798000
2023,District of Oak Bay,06-2030-00,V8S 4T1,,1161 HAMPSHIRE,1608000,1419000,314000,1733000
2023,District of Oak Bay,06-2031-00,V8S 4T1,,1149 HAMPSHIRE,1471000,1419000,188000,1607000
2023,District of Oak Bay,06-2032-00,V8S 4V6,,1250 MONTEREY,1528000,1461000,176000,1637000
2023,District of Oak Bay,06-2033-00,V8R 5G8,,1240 MONTEREY,1528000,1461000,173000,1634000
2023,District of Oak Bay,06-2034-00,V8S 4V6,,1230 MONTEREY,1687000,1461000,351000,1812000
2023,District of Oak Bay,06-2035-00,V8S 4V6,,1222 MONTEREY,1647000,1461000,300000,1761000
2023,District of Oak Bay,06-2036-00,V8S 4V6,,1210 MONTEREY,1699000,1462000,356000,1818000
2023,District of Oak Bay,06-2037-00,V8S 4V6,,1198 MONTEREY,1517000,1462000,164000,1626000
2023,District of Oak Bay,06-2038-00,V8S 4V6,,1186 MONTEREY,1556000,1460000,228000,1688000
2023,District of Oak Bay,06-2039-00,V8S 4V6,,1174 MONTEREY,2222000,1905000,501000,2406000
2023,District of Oak Bay,06-2039-00,V8S 4V6,,1174 MONTEREY,2222000,1905000,501000,2406000
2023,District of Oak Bay,06-2041-00,V8S 4V6,,1150 MONTEREY,1696000,1462000,354000,1816000
2023,District of Oak Bay,06-2042-00,V8S 4T1,,1141 HAMPSHIRE,1308000,1205000,201000,1406000
2023,District of Oak Bay,06-2042-00,V8S 4T1,,1141 HAMPSHIRE,1308000,1205000,201000,1406000
2023,District of Oak Bay,06-2043-00,V8S 4T1,,1101 HAMPSHIRE,1183100,1205000,66200,1271200
2023,District of Oak Bay,06-2043-00,V8S 4T1,,1101 HAMPSHIRE,1183100,1205000,66200,1271200
2023,District of Oak Bay,06-2044-00,V8S 3C9,,2220 WINDSOR,1187000,1205000,71900,1276900
2023,District of Oak Bay,06-2045-00,V8S 3C9,,2226 WINDSOR,1449000,1205000,341000,1546000
2023,District of Oak Bay,06-2046-00,V8S 3C9,,2232 WINDSOR,1277000,1205000,178000,1383000
2023,District of Oak Bay,06-2047-00,V8S 3C9,,2238 WINDSOR,1197300,1205000,84000,1289000
2023,District of Oak Bay,06-2048-00,V8S 4V6,,1138 MONTEREY,1298000,1252000,139000,1391000
2023,District of Oak Bay,06-2049-00,V8S 4V6,,1130 MONTEREY,1254000,1215000,131000,1346000
2023,District of Oak Bay,06-2050-00,V8S 3C4,,2133 WINDSOR,1897000,1088000,1025000,2113000
2023,District of Oak Bay,06-2051-00,V8S 3C4,,2141 WINDSOR,1153000,1096000,139000,1235000
2023,District of Oak Bay,06-2052-00,V8S 3C4,,2147 WINDSOR,1209000,1141000,182000,1323000
2023,District of Oak Bay,06-2053-00,V8S 4N9,,1075 VICTORIA,1179000,1120000,133000,1253000
2023,District of Oak Bay,06-2054-00,V8S 3C4,,2153 WINDSOR,2877000,1456000,1753000,3209000
2023,District of Oak Bay,06-2055-00,V9M 3T8,,2165 WINDSOR,1560000,1456000,243000,1699000
2023,District of Oak Bay,06-2056-00,V8S 4N9,,1067 VICTORIA,1427000,1222000,366000,1588000
2023,District of Oak Bay,06-2057-00,V8S 4N9,,1059 VICTORIA,1194300,1213000,71600,1284600
2023,District of Oak Bay,06-2058-00,V8S 4V5,,1051 VICTORIA,1228000,1205000,111000,1316000
2023,District of Oak Bay,06-2059-00,V8S 4N9,,1043 VICTORIA,1257000,1196000,174000,1370000
2023,District of Oak Bay,06-2059-00,V8S 4N9,,1043 VICTORIA,1257000,1196000,174000,1370000
2023,District of Oak Bay,06-2060-00,V8S 4N9,,1035 VICTORIA,1254000,1187000,183000,1370000
2023,District of Oak Bay,06-2061-00,V8S 4N9,,1027 VICTORIA,1149900,1179000,58100,1237100
2023,District of Oak Bay,06-2062-00,V8S 4R5,,1066 ROSLYN,1308000,1255000,170000,1425000
2023,District of Oak Bay,06-2063-00,V8S 4R5,,1058 ROSLYN,1309000,1254000,151000,1405000
2023,District of Oak Bay,06-2064-00,V8S 4R5,,1050 ROSLYN,1305000,1254000,146000,1400000
2023,District of Oak Bay,06-2065-00,V8S 4R5,,1042 ROSLYN,1714000,1254000,631000,1885000
2023,District of Oak Bay,06-2066-00,V8S 4R5,,1030 ROSLYN,1481000,1254000,338000,1592000
2023,District of Oak Bay,06-2067-00,V8S 4R5,,1026 ROSLYN,1451000,1254000,316000,1570000
2023,District of Oak Bay,06-2068-00,V8S 2Y3,,2144 MCNEILL,1220000,1156000,152000,1308000
2023,District of Oak Bay,06-2069-00,V8S 2Y3,,2148 MCNEILL,1202000,1129000,159000,1288000
2023,District of Oak Bay,06-2070-00,V8S 2Y3,,2156 MCNEILL,1184000,1069000,200000,1269000
2023,District of Oak Bay,06-2070-00,V8N 4L5,,2156 MCNEILL,1184000,1069000,200000,1269000
2023,District of Oak Bay,06-2071-00,V8S 2Y3,,2160 MCNEILL,1124000,1069000,136000,1205000
2023,District of Oak Bay,06-2072-00,V8S 2Y3,,2164 MCNEILL,1002800,967000,507000,1474000
2023,District of Oak Bay,06-2073-00,V8S 4R4,,1081 ROSLYN,1658000,1304000,500000,1804000
2023,District of Oak Bay,06-2073-00,V8S 4R4,,1081 ROSLYN,1658000,1304000,500000,1804000
2023,District of Oak Bay,06-2074-10,V8S 4R4,,1075 ROSLYN,2343000,1275000,1355000,2630000
2023,District of Oak Bay,06-2075-00,V8S 3C7,,2183 WINDSOR,1323000,1290000,153000,1443000
2023,District of Oak Bay,06-2076-00,V8S 3C7,,2189 WINDSOR,1345000,1290000,180000,1470000
2023,District of Oak Bay,06-2077-00,V8S 4S9,,1092 HAMPSHIRE,1399000,1290000,203000,1493000
2023,District of Oak Bay,06-2078-00,V8S 4R4,,1067 ROSLYN,1279000,1202000,196000,1398000
2023,District of Oak Bay,06-2079-00,V8S 4R4,,1059 ROSLYN,1240000,1203000,125000,1328000
2023,District of Oak Bay,06-2080-00,V8S 4R4,,1051 ROSLYN,1506000,1203000,437000,1640000
2023,District of Oak Bay,06-2081-00,V8S 4R4,,1043 ROSLYN,1268000,1202000,160000,1362000
2023,District of Oak Bay,06-2082-00,V8S 4R4,,1035 ROSLYN,2179000,1202000,1242000,2444000
2023,District of Oak Bay,06-2083-00,V5L 5G2,,1027 ROSLYN,1352000,1202000,247000,1449000
2023,District of Oak Bay,06-2084-00,V8S 4S9,,1068 HAMPSHIRE,1259000,1202000,147000,1349000
2023,District of Oak Bay,06-2085-00,V8S 4S9,,1060 HAMPSHIRE,1235000,1203000,140000,1343000
2023,District of Oak Bay,06-2086-00,V8S 4S9,,1052 HAMPSHIRE,1239000,1203000,144000,1347000
2023,District of Oak Bay,06-2087-00,V8S 4S9,,1044 HAMPSHIRE,2285000,1202000,1406000,2608000
2023,District of Oak Bay,06-2088-00,V8S 4S9,,1036 HAMPSHIRE,1238000,1203000,144000,1347000
2023,District of Oak Bay,06-2089-00,V8S 4S9,,1028 HAMPSHIRE,1271000,1202000,151000,1353000
2023,District of Oak Bay,06-2090-00,V8S 4R4,,1019 ROSLYN,1463000,1394000,176000,1570000
2023,District of Oak Bay,06-2091-00,V8S 2Y5,,2186 MCNEILL,1339000,1225000,209000,1434000
2023,District of Oak Bay,06-2092-00,V8S 4S9,,1016 HAMPSHIRE,1293000,1182000,240000,1422000
2023,District of Oak Bay,06-2092-00,V8S 4S9,,1016 HAMPSHIRE,1293000,1182000,240000,1422000
2023,District of Oak Bay,06-2093-10,V8S 4S9,,1010 HAMPSHIRE,2083000,1123000,1240000,2363000
2023,District of Oak Bay,06-2094-00,V8S 4S8,,1091 HAMPSHIRE,1360000,1279000,178000,1457000
2023,District of Oak Bay,06-2095-00,V8S 3C8,,2213 WINDSOR,1718000,1280000,563000,1843000
2023,District of Oak Bay,06-2095-00,,,2213 WINDSOR,1718000,1280000,563000,1843000
2023,District of Oak Bay,06-2096-00,V8S 3C8,,2219 WINDSOR,1384000,1279000,200000,1479000
2023,District of Oak Bay,06-2097-00,V8S 3C8,,2225 WINDSOR,1340000,1279000,158000,1437000
2023,District of Oak Bay,06-2098-00,V8S 3C8,,2231 WINDSOR,1701000,1279000,578000,1857000
2023,District of Oak Bay,06-2099-00,V8S 3C8,,2237 WINDSOR,1380000,1279000,197000,1476000
2023,District of Oak Bay,06-2100-00,V8S 3C8,,2245 WINDSOR,1623000,1279000,496000,1775000
2023,District of Oak Bay,06-2101-00,V5Z 1P2,,1068 MONTEREY,1527000,1300000,355000,1655000
2023,District of Oak Bay,06-2101-00,V6M 2J7,,1068 MONTEREY,1527000,1300000,355000,1655000
2023,District of Oak Bay,06-2102-00,V8S 4S8,,1067 HAMPSHIRE,1611000,1443000,302000,1745000
2023,District of Oak Bay,06-2103-00,V8S 4S8,,1059 HAMPSHIRE,1659000,1443000,352000,1795000
2023,District of Oak Bay,06-2104-00,V8S 4S8,,1051 HAMPSHIRE,1482000,1443000,159000,1602000
2023,District of Oak Bay,06-2105-00,V8S 4S8,,1043 HAMPSHIRE,1495000,1443000,163000,1606000
2023,District of Oak Bay,06-2106-00,V8S 4S8,,1039 HAMPSHIRE,1777000,1442000,469000,1911000
2023,District of Oak Bay,06-2107-00,V8S 4S8,,1027 HAMPSHIRE,1444000,1443000,107000,1550000
2023,District of Oak Bay,06-2108-00,V8S 4V5,,1058 MONTEREY,2682000,1443000,1533000,2976000
2023,District of Oak Bay,06-2109-00,V8S 4V5,,1050 MONTEREY,2011000,1443000,742000,2185000
2023,District of Oak Bay,06-2110-00,V8S 4V5,,1042 MONTEREY,1801000,1443000,476000,1919000
2023,District of Oak Bay,06-2111-00,V8S 4V5,,1038 MONTEREY,1524000,1443000,201000,1644000
2023,District of Oak Bay,06-2112-00,V8S 4V5,,1034 MONTEREY,1485000,1443000,154000,1597000
2023,District of Oak Bay,06-2113-00,,,1026 MONTEREY,1489000,1443000,186000,1629000
2023,District of Oak Bay,06-2114-00,V8S 4S8,,1015 HAMPSHIRE,1245000,1167000,170000,1337000
2023,District of Oak Bay,06-2115-00,V7C 5H8,,1009 HAMPSHIRE,1268000,1117000,251000,1368000
2023,District of Oak Bay,06-2116-00,V8S 4Z6,,2214 MCNEILL,1165000,1112000,136000,1248000
2023,District of Oak Bay,06-2117-00,V8S 2Y6,,2224 MCNEILL,1581000,1297000,417000,1714000
2023,District of Oak Bay,06-2118-00,V8S 2Y6,,2240 MCNEILL,1421000,1296000,229000,1525000
2023,District of Oak Bay,06-2119-00,V8S 2H6,,2250 MCNEILL,1194000,1118000,162000,1280000
2023,District of Oak Bay,06-2120-00,V8S 4V5,,1018 MONTEREY,1286000,1177000,203000,1380000
2023,District of Oak Bay,06-2120-00,V8S 4V5,,1018 MONTEREY,1286000,1177000,203000,1380000
2023,District of Oak Bay,06-2121-01,V8S 2Y7,,2273 MCNEILL,1429000,1173000,378000,1551000
2023,District of Oak Bay,06-2121-02,V8S 2Y7,,2275 MCNEILL,1437000,1182000,377000,1559000
2023,District of Oak Bay,06-2122-00,V6J 4E8,,988 OLIVER,1293000,1182000,195000,1377000
2023,District of Oak Bay,06-2123-00,V8S 4W6,,958 OLIVER,1456000,1310000,251000,1561000
2023,District of Oak Bay,06-2124-00,V8S 4W6,,946 OLIVER,1484000,1309000,282000,1591000
2023,District of Oak Bay,06-2126-00,V8Z 1E8,,924 OLIVER,617000,723000,0,723000
2023,District of Oak Bay,06-2127-00,V8Z 1E8,,914 OLIVER,617000,723000,0,723000
2023,District of Oak Bay,06-2128-00,V8R 1G2,, OLIVER,617000,723000,0,723000
2023,District of Oak Bay,06-2129-00,V8R 1G2,, OLIVER,617000,723000,0,723000
2023,District of Oak Bay,06-2130-00,V8R 1G2,, OLIVER,617000,723000,0,723000
2023,District of Oak Bay,06-2131-00,V8R 1G2,, OLIVER,617000,723000,0,723000
2023,District of Oak Bay,06-2132-00,V8R 1G2,, OLIVER,617000,723000,0,723000
2023,District of Oak Bay,06-2133-00,V8R 1G2,, OLIVER,617000,723000,0,723000
2023,District of Oak Bay,06-2134-00,V8R 1G2,, OLIVER,617000,723000,0,723000
2023,District of Oak Bay,06-2135-00,V8R 1G2,, OLIVER,617000,723000,0,723000
2023,District of Oak Bay,06-2136-00,V8Z 1E8,, OLIVER,617000,723000,0,723000
2023,District of Oak Bay,06-2137-00,V8S 4W4,,798 OLIVER,1693000,1448000,375000,1823000
2023,District of Oak Bay,06-2138-00,V8S 4W4,,776 OLIVER,2142000,1525000,814000,2339000
2023,District of Oak Bay,06-2139-00,V8S 4W4,,766 OLIVER,1623000,1307000,469000,1776000
2023,District of Oak Bay,06-2142-00,M5V 1A8,,2280 CENTRAL,1208000,1245000,54600,1299600
2023,District of Oak Bay,06-2143-00,V8S 4W4,,712 OLIVER,1383000,1262000,217000,1479000
2023,District of Oak Bay,06-2144-00,V8S 4W4,,724 OLIVER,2597000,1263000,1715000,2978000
2023,District of Oak Bay,06-2145-00,V8S 4W5,,985 OLIVER,1448000,1253000,304000,1557000
2023,District of Oak Bay,06-2145-00,V8S 4W5,,985 OLIVER,1448000,1253000,304000,1557000
2023,District of Oak Bay,06-2146-00,V8S 4W5,,977 OLIVER,1527000,1303000,353000,1656000
2023,District of Oak Bay,06-2147-00,V8S 2Z1,,2319 MCNEILL,1280000,1236000,157000,1393000
2023,District of Oak Bay,06-2147-01,V8S 2Z1,,2325 MCNEILL,1314000,1237000,171000,1408000
2023,District of Oak Bay,06-2148-00,V8S 4X5,,984 ST. PATRICK,1266000,1237000,123000,1360000
2023,District of Oak Bay,06-2148-01,V8R 1G2,, ST. PATRICK,4200,9600,0,9600
2023,District of Oak Bay,06-2149-00,V8N 2L5,,957 OLIVER,1321000,1285000,133000,1418000
2023,District of Oak Bay,06-2150-00,V8S 4W5,,947 OLIVER,2066000,1286000,961000,2247000
2023,District of Oak Bay,06-2151-00,V8S 4W5,,937 OLIVER,1464000,1285000,296000,1581000
2023,District of Oak Bay,06-2152-00,V8W 2L8,,925 OLIVER,1268000,1247000,115000,1362000
2023,District of Oak Bay,06-2153-00,V8S 4W5,,915 OLIVER,1483000,1247000,362000,1609000
2023,District of Oak Bay,06-2154-00,V8S 4W5,,907 OLIVER,1826000,1247000,747000,1994000
2023,District of Oak Bay,06-2155-00,V8S 4W5,,897 OLIVER,1399000,1247000,253000,1500000
2023,District of Oak Bay,06-2156-00,V8S 4W5,,885 OLIVER,1370000,1247000,257000,1504000
2023,District of Oak Bay,06-2157-00,V8S 4W5,,873 OLIVER,1646000,1441000,332000,1773000
2023,District of Oak Bay,06-2157-00,V8S 4W5,,873 OLIVER,1646000,1441000,332000,1773000
2023,District of Oak Bay,06-2158-00,V8S 4W5,,849 OLIVER,2940000,1426000,1844000,3270000
2023,District of Oak Bay,06-2159-00,V8S 4W5,,837 OLIVER,1390000,1221000,284000,1505000
2023,District of Oak Bay,06-2160-00,V8S 4W5,,827 OLIVER,1328000,1221000,163000,1384000
2023,District of Oak Bay,06-2161-00,V6N 3M2,,813 OLIVER,1373000,1247000,224000,1471000
2023,District of Oak Bay,06-2162-00,V8S 4W5,,789 OLIVER,1367000,1285000,180000,1465000
2023,District of Oak Bay,06-2163-00,V8S 4W5,,777 OLIVER,1335000,1285000,147000,1432000
2023,District of Oak Bay,06-2164-00,V8S 4W5,,767 OLIVER,1496000,1285000,317000,1602000
2023,District of Oak Bay,06-2165-00,V8S 4Z3,,755 OLIVER,1565000,1285000,404000,1689000
2023,District of Oak Bay,06-2166-00,V8S 4W5,,743 OLIVER,1365000,1285000,200000,1485000
2023,District of Oak Bay,06-2167-00,V8S 4X5,,958 ST. PATRICK,1462000,1286000,290000,1576000
2023,District of Oak Bay,06-2168-00,V8S 4X5,,948 ST. PATRICK,1332000,1286000,144000,1430000
2023,District of Oak Bay,06-2169-00,V8S 4X5,,936 ST. PATRICK,1340000,1286000,172000,1458000
2023,District of Oak Bay,06-2170-00,V8S 4X5,,924 ST. PATRICK,1400000,1286000,228000,1514000
2023,District of Oak Bay,06-2171-00,V8S 4X5,,912 ST. PATRICK,1888000,1675000,364000,2039000
2023,District of Oak Bay,06-2171-00,V8S 4X5,,912 ST. PATRICK,1888000,1675000,364000,2039000
2023,District of Oak Bay,06-2172-00,V8S 4X5,,890 ST. PATRICK,1329000,1285000,134000,1419000
2023,District of Oak Bay,06-2173-00,V8S 4X5,,880 ST. PATRICK,1680000,1285000,543000,1828000
2023,District of Oak Bay,06-2174-00,V8S 4X5,,870 ST. PATRICK,1464000,1285000,301000,1586000
2023,District of Oak Bay,06-2175-00,V8S 4X5,,860 ST. PATRICK,1608000,1286000,469000,1755000
2023,District of Oak Bay,06-2178-00,V8S 4X5,,824 ST. PATRICK,1709000,1285000,601000,1886000
2023,District of Oak Bay,06-2179-00,V8S 4X5,,798 ST. PATRICK,1638000,1285000,485000,1770000
2023,District of Oak Bay,06-2180-00,V8S 4X5,,786 ST. PATRICK,1281500,1285000,98700,1383700
2023,District of Oak Bay,06-2181-00,V8S 4X5,,776 ST. PATRICK,2334000,1285000,1385000,2670000
2023,District of Oak Bay,06-2182-00,V8S 4X5,,766 ST. PATRICK,1256400,1285000,65400,1350400
2023,District of Oak Bay,06-2183-10,V8S 4X5,,742 ST. PATRICK,3773000,1674000,2642000,4316000
2023,District of Oak Bay,06-2184-00,V8S 4X5,,710 ST. PATRICK,1426000,1320000,207000,1527000
2023,District of Oak Bay,06-2184-00,V8S 4X5,,710 ST. PATRICK,1426000,1320000,207000,1527000
2023,District of Oak Bay,06-2185-00,T2M 3B9,,730 ST. PATRICK,1367000,1320000,171000,1491000
2023,District of Oak Bay,06-2186-00,V8S 2S1,,2277 CENTRAL,2376000,1196000,1396000,2592000
2023,District of Oak Bay,06-2187-00,V8S 2S1,,2289 CENTRAL,1278000,1205000,161000,1366000
2023,District of Oak Bay,06-2188-00,V6H 2G5,,680 OLIVER,1694000,1205000,644000,1849000
2023,District of Oak Bay,06-2189-00,V8S 4W3,,662 OLIVER,1371000,1310000,159000,1469000
2023,District of Oak Bay,06-2190-00,V8S 4W3,,652 OLIVER,1531000,1349000,295000,1644000
2023,District of Oak Bay,06-2191-00,V8S 4W3,,640 OLIVER,2593000,1349000,1534000,2883000
2023,District of Oak Bay,06-2193-00,V8S 4W3,,618 OLIVER,1429000,1349000,189000,1538000
2023,District of Oak Bay,06-2194-00,V8S 4W3,,608 OLIVER,1674000,1348000,464000,1812000
2023,District of Oak Bay,06-2195-00,V8S 4W3,,596 OLIVER,1641000,1348000,441000,1789000
2023,District of Oak Bay,06-2196-00,V8S 4W3,,586 OLIVER,2700000,1348000,1599000,2947000
2023,District of Oak Bay,06-2197-00,V8S 4W3,,576 OLIVER,1525000,1348000,304000,1652000
2023,District of Oak Bay,06-2198-00,V8S 4W3,,564 OLIVER,1632000,1348000,412000,1760000
2023,District of Oak Bay,06-2199-00,V8S 4W3,,548 OLIVER,1890000,1348000,727000,2075000
2023,District of Oak Bay,06-2200-00,V8S 4W3,,530 OLIVER,1463000,1348000,234000,1582000
2023,District of Oak Bay,06-2201-00,V8S 4W3,,520 OLIVER,1457000,1348000,225000,1573000
2023,District of Oak Bay,06-2202-00,V8S 4W3,,510 OLIVER,1667000,1347000,455000,1802000
2023,District of Oak Bay,06-2203-00,V8S 4W3,,500 OLIVER,1410000,1347000,171000,1518000
2023,District of Oak Bay,06-2204-00,V8S 4W3,,480 OLIVER,1441000,1360000,181000,1541000
2023,District of Oak Bay,06-2205-00,M5V 1A8,,470 OLIVER,1676000,1504000,305000,1809000
2023,District of Oak Bay,06-2206-00,V8S 2M2,,350 BEACH,2409000,2349000,454000,2803000
2023,District of Oak Bay,06-2207-00,V8S 2M2,,360 BEACH,3067000,2302000,1282000,3584000
2023,District of Oak Bay,06-2208-00,V8S 4W2,,687 OLIVER,1438000,1279000,227000,1506000
2023,District of Oak Bay,06-2209-00,V8S 2S2,,2313 CENTRAL,1302000,1261000,134000,1395000
2023,District of Oak Bay,06-2210-00,V8V 4C5,,2319 CENTRAL,1125000,1072000,133000,1205000
2023,District of Oak Bay,06-2211-00,V8N 1K7,,2325 CENTRAL,3317800,2174000,1455000,3629000
2023,District of Oak Bay,06-2212-00,,,663 OLIVER,1454000,1285000,272000,1557000
2023,District of Oak Bay,06-2213-00,V8S 4W2,,651 OLIVER,1383000,1323000,160000,1483000
2023,District of Oak Bay,06-2214-00,V8S 4W2,,641 OLIVER,2893000,1324000,1863000,3187000
2023,District of Oak Bay,06-2215-00,V8S 4W2,,631 OLIVER,1352000,1324000,364000,1688000
2023,District of Oak Bay,06-2216-00,V8S 4W2,,619 OLIVER,2403000,1324000,1399000,2723000
2023,District of Oak Bay,06-2216-00,V8S 4W2,,619 OLIVER,2403000,1324000,1399000,2723000
2023,District of Oak Bay,06-2217-00,V8S 4W2,,609 OLIVER,2773000,1324000,1933000,3257000
2023,District of Oak Bay,06-2217-00,V8S 4W2,,609 OLIVER,2773000,1324000,1933000,3257000
2023,District of Oak Bay,06-2218-00,V8S 4W2,,597 OLIVER,1404000,1324000,182000,1506000
2023,District of Oak Bay,06-2219-00,V8N 0B1,,587 OLIVER,1358000,1324000,132000,1456000
2023,District of Oak Bay,06-2220-00,V8S 4W2,,577 OLIVER,1393000,1324000,164000,1488000
2023,District of Oak Bay,06-2221-00,V8S 4W2,,565 OLIVER,1610000,1324000,416000,1740000
2023,District of Oak Bay,06-2222-00,V8S 4W2,,551 OLIVER,1376000,1324000,151000,1475000
2023,District of Oak Bay,06-2223-00,V8S 4W2,,543 OLIVER,1491000,1325000,272000,1597000
2023,District of Oak Bay,06-2224-00,V7R 1V8,,531 OLIVER,1521000,1325000,326000,1651000
2023,District of Oak Bay,06-2225-00,V8S 4W2,,523 OLIVER,2485000,1325000,1473000,2798000
2023,District of Oak Bay,06-2226-00,V8S 4W2,,509 OLIVER,1695000,1325000,521000,1846000
2023,District of Oak Bay,06-2227-00,V8S 4W2,,495 OLIVER,2481000,1325000,1455000,2780000
2023,District of Oak Bay,06-2228-00,V8S 4W2,,485 OLIVER,1348000,1338000,104000,1442000
2023,District of Oak Bay,06-2229-00,V8S 4W2,,469 OLIVER,1527000,1351000,300000,1651000
2023,District of Oak Bay,06-2230-00,V8S 4X3,,662 ST. PATRICK,1300500,1323000,74400,1397400
2023,District of Oak Bay,06-2230-01,V8S 4X3,,650 ST. PATRICK,1412000,1323000,193000,1516000
2023,District of Oak Bay,06-2230-01,V8S 4X3,,650 ST. PATRICK,1412000,1323000,193000,1516000
2023,District of Oak Bay,06-2231-00,V8S 4X3,,640 ST. PATRICK,1372000,1323000,147000,1470000
2023,District of Oak Bay,06-2232-00,V8S 4X3,,624 ST. PATRICK,1636000,1323000,456000,1779000
2023,District of Oak Bay,06-2233-00,V8S 4X3,,618 ST. PATRICK,1489000,1323000,280000,1603000
2023,District of Oak Bay,06-2234-00,V8S 4X3,,608 ST. PATRICK,2196000,1324000,1162000,2486000
2023,District of Oak Bay,06-2235-00,V8S 4X3,,590 ST. PATRICK,1367000,1323000,143000,1466000
2023,District of Oak Bay,06-2236-00,V8S 4X3,,584 ST. PATRICK,1406000,1324000,184000,1508000
2023,District of Oak Bay,06-2237-00,V8S 4X3,,576 ST. PATRICK,1426000,1324000,206000,1530000
2023,District of Oak Bay,06-2238-00,V8S 4X3,,564 ST. PATRICK,1394000,1324000,172000,1496000
2023,District of Oak Bay,06-2239-00,V8S 2S6,,552 ST. PATRICK,1395000,1324000,174000,1498000
2023,District of Oak Bay,06-2240-00,V8S 4X3,,542 ST. PATRICK,1395000,1324000,171000,1495000
2023,District of Oak Bay,06-2241-00,V8S 4X3,,530 ST. PATRICK,1369000,1324000,143000,1467000
2023,District of Oak Bay,06-2242-00,T6G 1S5,,520 ST. PATRICK,1305900,1324000,80000,1404000
2023,District of Oak Bay,06-2243-00,V8S 4X3,,500 ST. PATRICK,2462000,1324000,1429000,2753000
2023,District of Oak Bay,06-2244-00,V8S 4X3,,492 ST. PATRICK,1518000,1337000,308000,1645000
2023,District of Oak Bay,06-2245-00,V8S 4W2,,453 OLIVER,2838000,2055000,1373000,3428000
2023,District of Oak Bay,06-2246-00,V8E 0G1,,370 BEACH,2320000,1994000,702000,2696000
2023,District of Oak Bay,06-2247-00,V8S 2M3,,376 BEACH,1999000,1956000,374000,2330000
2023,District of Oak Bay,06-2248-00,V8R 2A2,,2612 CRANMORE,1753000,1483000,435000,1918000
2023,District of Oak Bay,06-2249-01,V8R 2A2,,2624 CRANMORE,1993000,1483000,716000,2199000
2023,District of Oak Bay,06-2249-02,V8R 2A2,,2634 CRANMORE,1759000,1482000,444000,1926000
2023,District of Oak Bay,06-2250-00,V8R 2C8,,2652 ANSCOMB,1872000,1843000,208000,2051000
2023,District of Oak Bay,06-2250-00,V6J 1T5,,2652 ANSCOMB,1872000,1843000,208000,2051000
2023,District of Oak Bay,06-2251-00,V8R 6J5,,1908 BEACH,3080000,1890000,1570000,3460000
2023,District of Oak Bay,06-2252-00,V8R 6J5,,1928 BEACH,1921000,1841000,259000,2100000
2023,District of Oak Bay,06-2253-00,V8S 4Y3,,1135 ST. PATRICK,1392000,1323000,191000,1514000
2023,District of Oak Bay,06-2254-00,V8S 3E5,,2346 WINDSOR,1804000,1324000,651000,1975000
2023,District of Oak Bay,06-2255-00,V8S 4Y3,,1147 ST. PATRICK,1411000,1385000,152000,1537000
2023,District of Oak Bay,06-2256-00,V8S 4Y3,,1161 ST. PATRICK,1417000,1385000,150000,1535000
2023,District of Oak Bay,06-2257-00,V8S 4Y3,,1175 ST. PATRICK,1551000,1385000,324000,1709000
2023,District of Oak Bay,06-2257-00,V8R 2L8,,1175 ST. PATRICK,1551000,1385000,324000,1709000
2023,District of Oak Bay,06-2258-00,V8S 4Y3,,1191 ST. PATRICK,1506000,1384000,236000,1620000
2023,District of Oak Bay,06-2259-00,V8S 4X8,,893 ST. PATRICK,1426000,1282000,253000,1535000
2023,District of Oak Bay,06-2260-00,V8S 4X8,,879 ST. PATRICK,1385000,1282000,214000,1496000
2023,District of Oak Bay,06-2261-00,V8S 2X2,,2362 ZELA,1326000,1221000,199000,1420000
2023,District of Oak Bay,06-2262-00,V8S 2X2,,2366 ZELA,1477000,1221000,373000,1594000
2023,District of Oak Bay,06-2263-00,V8S 2X2,,2372 ZELA,1385000,1221000,292000,1513000
2023,District of Oak Bay,06-2264-00,V8S 2X2,,2378 ZELA,1315000,1221000,200000,1421000
2023,District of Oak Bay,06-2265-00,V8S 4Z9,,896 TRANSIT,2547000,1280000,1541000,2821000
2023,District of Oak Bay,06-2266-00,V8S 4Z9,,888 TRANSIT,1326000,1280000,145000,1425000
2023,District of Oak Bay,06-2267-00,V8S 4X7,,865 ST. PATRICK,1351000,1281000,168000,1449000
2023,District of Oak Bay,06-2268-00,V8S 4X7,,841 ST. PATRICK,1364000,1281000,181000,1462000
2023,District of Oak Bay,06-2269-00,V8S 4X7,,829 ST. PATRICK,1464000,1281000,290000,1571000
2023,District of Oak Bay,06-2270-00,V8S 4X7,,817 ST. PATRICK,1320000,1282000,134000,1416000
2023,District of Oak Bay,06-2271-00,V8S 2X1,,2361 ZELA,1342000,1221000,209000,1430000
2023,District of Oak Bay,06-2272-00,V8S 2X1,,2367 ZELA,2437000,1221000,1502000,2723000
2023,District of Oak Bay,06-2273-00,V8S 2X1,,2373 ZELA,2273000,1221000,1310000,2531000
2023,District of Oak Bay,06-2274-00,V8S 2X1,,2377 ZELA,1174300,1221000,44900,1265900
2023,District of Oak Bay,06-2275-00,V8S 2W8,,2360 ROSARIO,1292000,1221000,166000,1387000
2023,District of Oak Bay,06-2276-00,V8R 6K5,,2368 ROSARIO,1290000,1221000,179000,1400000
2023,District of Oak Bay,06-2277-00,V8S 2W8,,2374 ROSARIO,1285000,1221000,152000,1373000
2023,District of Oak Bay,06-2278-00,V8S 2W8,,2378 ROSARIO,1395000,1221000,277000,1498000
2023,District of Oak Bay,06-2279-00,V8S 2X1,,2385 ZELA,1930000,1280000,839000,2119000
2023,District of Oak Bay,06-2280-00,V8S 4Z8,,830 TRANSIT,2371000,1280000,1425000,2705000
2023,District of Oak Bay,06-2281-00,V8S 4Z8,,820 TRANSIT,1422000,1280000,242000,1522000
2023,District of Oak Bay,06-2282-00,V8S 4Z8,,812 TRANSIT,1475000,1280000,300000,1580000
2023,District of Oak Bay,06-2283-00,V8S 4X6,,789 ST. PATRICK,1414000,1281000,236000,1517000
2023,District of Oak Bay,06-2284-00,V8S 4X6,,777 ST. PATRICK,1383000,1285000,196000,1481000
2023,District of Oak Bay,06-2285-00,V8S 2W9,,2361 ROSARIO,1292000,1223000,169000,1392000
2023,District of Oak Bay,06-2286-00,V8S 2W9,,2367 ROSARIO,1274000,1223000,143000,1366000
2023,District of Oak Bay,06-2287-00,V8S 2W9,,2375 ROSARIO,1299000,1223000,164000,1387000
2023,District of Oak Bay,06-2288-00,V8S 2W9,,2379 ROSARIO,1284000,1223000,150000,1373000
2023,District of Oak Bay,06-2289-00,V8S 2W9,,2383 ROSARIO,1173700,1215000,52600,1267600
2023,District of Oak Bay,06-2289-00,V8S 2W9,,2383 ROSARIO,1173700,1215000,52600,1267600
2023,District of Oak Bay,06-2290-00,V8S 4Z6,,788 TRANSIT,1386000,1344000,144000,1488000
2023,District of Oak Bay,06-2291-00,V8S 4Z7,,889 TRANSIT,1647000,1385000,374000,1759000
2023,District of Oak Bay,06-2292-00,V8S 4Z7,,899 TRANSIT,2073000,1385000,849000,2234000
2023,District of Oak Bay,06-2293-00,V8S 4Z7,,909 TRANSIT,1726000,1385000,472000,1857000
2023,District of Oak Bay,06-2294-00,V8S 4Z7,,919 TRANSIT,1535000,1385000,272000,1657000
2023,District of Oak Bay,06-2295-00,V8S 4Z7,,931 TRANSIT,2285000,1385000,1157000,2542000
2023,District of Oak Bay,06-2296-00,V8S 4Z7,,941 TRANSIT,1460000,1385000,204000,1589000
2023,District of Oak Bay,06-2297-00,V8S 4Z7,,953 TRANSIT,1582000,1385000,309000,1694000
2023,District of Oak Bay,06-2298-00,V8S 4Z7,,963 TRANSIT,1478000,1385000,209000,1594000
2023,District of Oak Bay,06-2299-00,V8S 4Z7,,967 TRANSIT,1439000,1385000,159000,1544000
2023,District of Oak Bay,06-2300-00,V8S 4Z7,,977 TRANSIT,1423000,1332000,187000,1519000
2023,District of Oak Bay,06-2303-00,V8S 2T9,,962 ISLAND,1850000,1574000,430000,2004000
2023,District of Oak Bay,06-2304-00,V8S 2T9,,944 ISLAND,3434000,1656000,1990000,3646000
2023,District of Oak Bay,06-2305-00,V8S 2T9,,928 ISLAND,1962000,1385000,770000,2155000
2023,District of Oak Bay,06-2306-00,V8S 2T9,,916 ISLAND,1413000,1385000,132000,1517000
2023,District of Oak Bay,06-2307-00,V8S 2T9,,904 ISLAND,1452000,1385000,182000,1567000
2023,District of Oak Bay,06-2308-00,V8S 2T9,,894 ISLAND,1428000,1385000,170000,1555000
2023,District of Oak Bay,06-2309-00,V8S 2T9,,882 ISLAND,1694000,1385000,465000,1850000
2023,District of Oak Bay,06-2311-00,V8S 4X9,,963 ST. PATRICK,1253000,1216000,144000,1360000
2023,District of Oak Bay,06-2312-00,V8S 4X9,,953 ST. PATRICK,1335000,1217000,225000,1442000
2023,District of Oak Bay,06-2313-00,V9E 2A3,,2350 COOKMAN,1713000,1217000,623000,1840000
2023,District of Oak Bay,06-2317-00,V8S 2Z2,,2365 MCNEILL,1332000,1101000,340000,1441000
2023,District of Oak Bay,06-2319-00,V8S 2Z2,,2371 MCNEILL,1191000,1101000,171000,1272000
2023,District of Oak Bay,06-2320-00,V8S 2X4,,2374 COOKMAN,1150500,1159000,85600,1244600
2023,District of Oak Bay,06-2321-00,V8S 2Z2,,2375 MCNEILL,1111900,1101000,95200,1196200
2023,District of Oak Bay,06-2322-00,V8S 2X4,,2380 COOKMAN,1209000,1160000,139000,1299000
2023,District of Oak Bay,06-2323-00,V8S 2Z2,,2379 MCNEILL,1127000,1101000,103000,1204000
2023,District of Oak Bay,06-2324-00,V8S 2Z2,,2385 MCNEILL,1293000,1155000,232000,1387000
2023,District of Oak Bay,06-2325-00,V8S 5A1,,976 TRANSIT,1334000,1215000,215000,1430000
2023,District of Oak Bay,06-2326-00,V8S 5A1,,966 TRANSIT,1477000,1216000,372000,1588000
2023,District of Oak Bay,06-2327-00,V8S 5A1,,954 TRANSIT,1264000,1215000,136000,1351000
2023,District of Oak Bay,06-2328-00,V8S 5A1,,944 TRANSIT,1191200,1215000,65300,1280300
2023,District of Oak Bay,06-2329-00,V8S 4Z9,,920 TRANSIT,1370000,1324000,146000,1470000
2023,District of Oak Bay,06-2330-00,V8S 4Z9,,910 TRANSIT,2327000,1316000,1250000,2566000
2023,District of Oak Bay,06-2331-00,V8S 2X3,,2377 COOKMAN,1237000,1156000,172000,1328000
2023,District of Oak Bay,06-2332-00,V8S 2X3,,2373 COOKMAN,1221000,1156000,154000,1310000
2023,District of Oak Bay,06-2333-00,V8S 2X3,,2367 COOKMAN,1164700,1156000,96700,1252700
2023,District of Oak Bay,06-2334-00,V8S 2X3,,2363 COOKMAN,1373000,1156000,324000,1480000
2023,District of Oak Bay,06-2335-00,V8S 2X3,,2359 COOKMAN,1236000,1156000,182000,1338000
2023,District of Oak Bay,06-2335-00,V8N 6B7,,2359 COOKMAN,1236000,1156000,182000,1338000
2023,District of Oak Bay,07-2336-00,V8S 2W2,,2170 BEAVERBROOKE,1453000,1271000,285000,1556000
2023,District of Oak Bay,07-2337-00,V8S 2W2,,2174 BEAVERBROOKE,2359000,1273000,1334000,2607000
2023,District of Oak Bay,07-2338-00,V8S 2W2,,2178 BEAVERBROOKE,1729000,1273000,626000,1899000
2023,District of Oak Bay,07-2339-00,V8S 2W2,,2182 BEAVERBROOKE,1357000,1273000,181000,1454000
2023,District of Oak Bay,07-2340-00,V8S 4S5,,824 HAMPSHIRE,1618000,1273000,441000,1714000
2023,District of Oak Bay,07-2341-00,V8S 4S5,,828 HAMPSHIRE,1316000,1273000,138000,1411000
2023,District of Oak Bay,07-2342-00,V8S 2W1,,2195 BEAVERBROOKE,1322000,1273000,145000,1418000
2023,District of Oak Bay,07-2343-00,V8N 1K7,,2189 BEAVERBROOKE,1282600,1273000,103000,1376000
2023,District of Oak Bay,07-2344-00,V8S 2W1,,2183 BEAVERBROOKE,1299000,1273000,114000,1387000
2023,District of Oak Bay,07-2345-00,V8S 2W1,,2179 BEAVERBROOKE,1387000,1273000,213000,1486000
2023,District of Oak Bay,07-2346-00,V8S 2W1,,2175 BEAVERBROOKE,1307000,1273000,128000,1401000
2023,District of Oak Bay,07-2347-00,V8S 2W1,,2169 BEAVERBROOKE,1619000,1273000,468000,1741000
2023,District of Oak Bay,07-2348-01,V8S 2W1,,2165 BEAVERBROOKE,1517000,972000,653000,1625000
2023,District of Oak Bay,07-2348-02,V8S 2W1,,2161 BEAVERBROOKE,1467000,923000,649000,1572000
2023,District of Oak Bay,07-2349-00,V8S 4N2,,777 VICTORIA,1273000,1204000,163000,1367000
2023,District of Oak Bay,07-2349-00,V8S 4N2,,777 VICTORIA,1273000,1204000,163000,1367000
2023,District of Oak Bay,07-2350-00,V8S 4Y9,,1200 ST. DAVID,1449000,1384000,169000,1553000
2023,District of Oak Bay,07-2351-00,V8S 4Y9,,1174 ST. DAVID,1711000,1386000,476000,1862000
2023,District of Oak Bay,07-2352-00,V8S 4Y9,,1160 ST. DAVID,1822000,1385000,598000,1983000
2023,District of Oak Bay,07-2353-00,V8S 4Y9,,1146 ST. DAVID,1422000,1383000,167000,1550000
2023,District of Oak Bay,07-2354-00,V8S 3E5,,2354 WINDSOR,1624000,1322000,440000,1762000
2023,District of Oak Bay,07-2355-00,V8S 3E5,,2360 WINDSOR,1634000,1323000,447000,1770000
2023,District of Oak Bay,07-2356-00,V8S 2T8,,821 ISLAND,1454000,1420000,141000,1561000
2023,District of Oak Bay,07-2357-10,V8S 2T8,,813 ISLAND,3073000,1851000,1518000,3369000
2023,District of Oak Bay,07-2358-00,V8R 1G5,,785 ISLAND,2158000,1578000,1591000,3169000
2023,District of Oak Bay,07-2358-00,V8R 1G5,,785 ISLAND,2158000,1578000,1591000,3169000
2023,District of Oak Bay,07-2359-01,V8S 2T8,,773 ISLAND,1379000,1211000,289000,1500000
2023,District of Oak Bay,07-2361-00,V8S 5H1,,2464 PLUMER,1307000,1211000,191000,1402000
2023,District of Oak Bay,07-2362-00,V8S 5H1,,2472 PLUMER,1277000,1211000,163000,1374000
2023,District of Oak Bay,07-2363-00,V9E 1J4,,2480 PLUMER,1251000,1210000,131000,1341000
2023,District of Oak Bay,07-2363-00,V8P 4C2,,2480 PLUMER,1251000,1210000,131000,1341000
2023,District of Oak Bay,07-2364-00,V8S 5H1,,2488 PLUMER,2338000,1210000,1424000,2634000
2023,District of Oak Bay,07-2365-00,V8S 5H1,,2494 PLUMER,1490000,1175000,442000,1617000
2023,District of Oak Bay,07-2366-00,V8S 2T8,,735 ISLAND,1315000,1210000,199000,1409000
2023,District of Oak Bay,07-2367-00,V8S 2T8,,749 ISLAND,1475000,1211000,389000,1600000
2023,District of Oak Bay,07-2368-00,V8S 5G9,,2457 PLUMER,1260000,1209000,142000,1351000
2023,District of Oak Bay,07-2369-00,V8L 2N8,,2465 PLUMER,1268000,1209000,90000,1299000
2023,District of Oak Bay,07-2370-00,V8S 5G9,,2473 PLUMER,1433000,1208000,347000,1555000
2023,District of Oak Bay,07-2371-00,V6S 1J1,,2481 PLUMER,2331000,1207000,1415000,2622000
2023,District of Oak Bay,07-2372-00,V8S 5G9,,2487 PLUMER,1288000,1206000,175000,1381000
2023,District of Oak Bay,07-2373-00,V8S 5B2,,736 BYNG,1255000,1219000,128000,1347000
2023,District of Oak Bay,07-2374-00,V0N 2W2,,2450 CENTRAL,1132000,1212000,720000,1932000
2023,District of Oak Bay,07-2374-50,V8S 2S8,,2460 CENTRAL,1790000,1212000,1206000,2418000
2023,District of Oak Bay,07-2374-50,V8S 2S8,,2460 CENTRAL,1790000,1212000,1206000,2418000
2023,District of Oak Bay,07-2375-00,V8S 2S8,,2464 CENTRAL,1275000,1212000,154000,1366000
2023,District of Oak Bay,07-2376-00,V8S 2S8,,2470 CENTRAL,1679000,1212000,592000,1804000
2023,District of Oak Bay,07-2377-00,V8S 2S8,,2476 CENTRAL,1365000,1211000,258000,1469000
2023,District of Oak Bay,07-2378-00,V8S 2S8,,2482 CENTRAL,1393000,1210000,304000,1514000
2023,District of Oak Bay,07-2379-00,V8S 2S8,,2488 CENTRAL,1249000,1209000,131000,1340000
2023,District of Oak Bay,07-2380-00,V8N 6G1,,2494 CENTRAL,1245100,1253000,1006000,2259000
2023,District of Oak Bay,07-2381-00,V8S 2R6,,2159 CENTRAL,1257000,1201000,144000,1345000
2023,District of Oak Bay,07-2382-00,V8S 2R6,,2163 CENTRAL,1219000,1183000,123000,1306000
2023,District of Oak Bay,07-2383-00,V8S 2R6,,2167 CENTRAL,1356000,1192000,279000,1471000
2023,District of Oak Bay,07-2384-00,V8S 2R6,,2173 CENTRAL,1237000,1192000,133000,1325000
2023,District of Oak Bay,07-2385-00,V8S 2R6,,2177 CENTRAL,1222000,1193000,116000,1309000
2023,District of Oak Bay,07-2386-00,V8S 2R6,,2183 CENTRAL,1228000,1192000,124000,1316000
2023,District of Oak Bay,07-2387-00,V8S 2L9,,2187 CENTRAL,1183300,1192000,185000,1377000
2023,District of Oak Bay,07-2388-00,V8S 4S2,,686 HAMPSHIRE,1422000,1191000,340000,1531000
2023,District of Oak Bay,07-2389-00,V8S 2P9,,2194 BARTLETT,1282000,1192000,181000,1373000
2023,District of Oak Bay,07-2390-00,V8S 2P9,,2188 BARTLETT,1866000,1192000,871000,2063000
2023,District of Oak Bay,07-2391-00,V8S 2P9,,2184 BARTLETT,1241000,1192000,128000,1320000
2023,District of Oak Bay,07-2392-00,V8S 2P9,,2178 BARTLETT,1685000,1193000,665000,1858000
2023,District of Oak Bay,07-2393-00,V8S 2P9,,2174 BARTLETT,1268000,1193000,167000,1360000
2023,District of Oak Bay,07-2394-00,V8S 2P9,,2168 BARTLETT,1311000,1192000,221000,1413000
2023,District of Oak Bay,07-2395-00,V8S 2P9,,2164 BARTLETT,1196300,1188000,90800,1278800
2023,District of Oak Bay,07-2396-00,V8S 2P9,,2160 BARTLETT,1425000,1196000,324000,1520000
2023,District of Oak Bay,07-2397-00,V8S 4M9,,625 VICTORIA,1243000,1193000,140000,1333000
2023,District of Oak Bay,07-2398-10,V8S 3J4,,605 VICTORIA,1245000,1193000,140000,1333000
2023,District of Oak Bay,07-2399-01,V8S 2R1,,2171 BARTLETT,2251000,1191000,1359000,2550000
2023,District of Oak Bay,07-2399-02,V8S 2R1,,2175 BARTLETT,2266000,1193000,1375000,2568000
2023,District of Oak Bay,07-2400-01,V6C 3R8,,2179 BARTLETT,1114000,1193000,0,1193000
2023,District of Oak Bay,07-2400-02,V6C 3R8,,2185 BARTLETT,1751000,1193000,726000,1919000
2023,District of Oak Bay,07-2401-00,V8S 2R1,,2189 BARTLETT,1853000,1193000,888000,2081000
2023,District of Oak Bay,07-2402-00,V8S 4S1,,620 HAMPSHIRE,1276000,1193000,179000,1372000
2023,District of Oak Bay,07-2403-00,V9N 8N8,,590 HAMPSHIRE,1221000,1191000,122000,1313000
2023,District of Oak Bay,07-2404-00,V8S 2P6,,2188 GUERNSEY,1242000,1191000,139000,1330000
2023,District of Oak Bay,07-2405-00,V8S 2P6,,2184 GUERNSEY,1542000,1191000,482000,1673000
2023,District of Oak Bay,07-2406-00,V8S 2P6,,2180 GUERNSEY,1174500,1191000,73600,1264600
2023,District of Oak Bay,07-2407-00,V8S 2P6,,2174 GUERNSEY,1300000,1192000,202000,1394000
2023,District of Oak Bay,07-2408-00,V8S 2P6,,2168 GUERNSEY,1362000,1193000,281000,1474000
2023,District of Oak Bay,07-2411-00,V8S 2R7,,2201 CENTRAL,1298000,1253000,138000,1391000
2023,District of Oak Bay,07-2412-00,V8Z 4H8,,686 MONTEREY,1931000,1252000,905000,2157000
2023,District of Oak Bay,07-2413-00,V8S 4R9,,675 HAMPSHIRE,1356000,1253000,203000,1456000
2023,District of Oak Bay,07-2414-00,V8S 4T9,,674 MONTEREY,1327000,1253000,168000,1421000
2023,District of Oak Bay,07-2415-00,V8S 4R9,,663 HAMPSHIRE,1363000,1290000,164000,1454000
2023,District of Oak Bay,07-2416-00,V8R 6H3,,662 MONTEREY,1355000,1290000,156000,1446000
2023,District of Oak Bay,07-2417-00,V8S 4R9,,651 HAMPSHIRE,1422000,1290000,242000,1532000
2023,District of Oak Bay,07-2418-00,V8S 4T9,,650 MONTEREY,1248800,1290000,55000,1345000
2023,District of Oak Bay,07-2419-00,V8S 4R9,,639 HAMPSHIRE,1405000,1290000,217000,1507000
2023,District of Oak Bay,07-2420-00,V8S 4T9,,638 MONTEREY,1391000,1290000,200000,1490000
2023,District of Oak Bay,07-2421-00,V8S 4R9,,627 HAMPSHIRE,1361000,1334000,126000,1460000
2023,District of Oak Bay,07-2422-00,V8S 4T9,,626 MONTEREY,1959000,1334000,735000,2069000
2023,District of Oak Bay,07-2422-00,V8S 4T9,,626 MONTEREY,1959000,1334000,735000,2069000
2023,District of Oak Bay,07-2423-00,V8S 4R9,,615 HAMPSHIRE,2431000,1334000,1401000,2735000
2023,District of Oak Bay,07-2424-00,V8S 4T9,,614 MONTEREY,1869000,1334000,729000,2063000
2023,District of Oak Bay,07-2425-00,V8S 4R9,,603 HAMPSHIRE,1386000,1291000,216000,1507000
2023,District of Oak Bay,07-2426-00,V8W 2L8,,602 MONTEREY,1292600,1291000,97100,1388100
2023,District of Oak Bay,07-2427-00,V8S 4R9,,589 HAMPSHIRE,2012000,1291000,901000,2192000
2023,District of Oak Bay,07-2428-00,V8S 4T9,,590 MONTEREY,1495000,1291000,314000,1605000
2023,District of Oak Bay,07-2429-00,V8S 4R9,,577 HAMPSHIRE,2538000,1291000,1532000,2823000
2023,District of Oak Bay,07-2430-00,V8S 4T9,,576 MONTEREY,1482000,1291000,304000,1595000
2023,District of Oak Bay,07-2431-00,V8S 4R9,,565 HAMPSHIRE,1489000,1291000,301000,1592000
2023,District of Oak Bay,07-2432-00,V8S 4T9,,564 MONTEREY,1426000,1290000,246000,1536000
2023,District of Oak Bay,07-2433-00,V8S 4R9,,553 HAMPSHIRE,1287800,1291000,88400,1379400
2023,District of Oak Bay,07-2434-00,V8S 4T9,,560 MONTEREY,1316000,1290000,124000,1414000
2023,District of Oak Bay,07-2435-00,V8S 4V2,,988 MONTEREY,1178000,1129000,133000,1262000
2023,District of Oak Bay,07-2435-01,V8S 4V2,,976 MONTEREY,1331000,1188000,230000,1418000
2023,District of Oak Bay,07-2436-00,V8S 4V2,,966 MONTEREY,2322000,1189000,1369000,2558000
2023,District of Oak Bay,07-2437-00,V8S 4V2,,954 MONTEREY,2240000,1190000,1309000,2499000
2023,District of Oak Bay,07-2438-00,V8S 4V2,,942 MONTEREY,1173000,1190000,66100,1256100
2023,District of Oak Bay,07-2439-00,V8S 4V2,,936 MONTEREY,1334000,1190000,242000,1432000
2023,District of Oak Bay,07-2440-00,V8S 4V2,,924 MONTEREY,2081000,1145000,1190000,2335000
2023,District of Oak Bay,07-2441-00,V8S 4S3,,923 HAMPSHIRE,1686000,1180000,651000,1831000
2023,District of Oak Bay,07-2442-00,V8S 4S3,,933 HAMPSHIRE,1258000,1190000,177000,1367000
2023,District of Oak Bay,07-2443-00,V8S 4S3,,943 HAMPSHIRE,1463000,1190000,446000,1636000
2023,District of Oak Bay,07-2443-00,V8S 4S3,,943 HAMPSHIRE,1463000,1190000,446000,1636000
2023,District of Oak Bay,07-2444-00,V8S 4S3,,953 HAMPSHIRE,1434000,1190000,345000,1535000
2023,District of Oak Bay,07-2445-00,V8S 4S3,,965 HAMPSHIRE,1361000,1190000,275000,1465000
2023,District of Oak Bay,07-2446-00,V8S 4S3,,977 HAMPSHIRE,1245000,1189000,161000,1350000
2023,District of Oak Bay,07-2447-00,V8S 4S3,,989 HAMPSHIRE,1233000,1131000,195000,1326000
2023,District of Oak Bay,07-2448-00,V8R 5B8,,2761 FOUL BAY,866700,875000,68300,943300
2023,District of Oak Bay,07-2448-01,V8R 2V2,,2021 CARNARVON,1218000,1027000,305000,1332000
2023,District of Oak Bay,07-2451-00,V8Y 2W7,,2023 CARNARVON,1251000,1083000,269000,1352000
2023,District of Oak Bay,07-2451-00,V8Y 2W7,,2023 CARNARVON,1251000,1083000,269000,1352000
2023,District of Oak Bay,07-2452-00,V8R 2V2,,2029 CARNARVON,1215000,1083000,224000,1307000
2023,District of Oak Bay,07-2453-00,V8R 2V2,,2035 CARNARVON,1128000,1083000,142000,1225000
2023,District of Oak Bay,07-2454-00,V8R 2V2,,2041 CARNARVON,1269000,1083000,291000,1374000
2023,District of Oak Bay,07-2455-00,V8R 2V2,,2047 CARNARVON,1131000,1083000,144000,1227000
2023,District of Oak Bay,07-2456-00,V8R 2V2,,2053 CARNARVON,1134000,1083000,148000,1231000
2023,District of Oak Bay,07-2457-00,V8R 2V2,,2059 CARNARVON,1142000,1083000,152000,1235000
2023,District of Oak Bay,07-2458-00,V8R 2V2,,2065 CARNARVON,1649000,1083000,716000,1799000
2023,District of Oak Bay,07-2459-00,V8R 2V2,,2071 CARNARVON,1103000,1083000,117000,1200000
2023,District of Oak Bay,07-2460-00,V8R 2V2,,2077 CARNARVON,1135000,1083000,150000,1233000
2023,District of Oak Bay,07-2461-00,V8R 2V2,,2083 CARNARVON,1198000,1083000,215000,1298000
2023,District of Oak Bay,07-2462-00,V8R 2V2,,2091 CARNARVON,1259000,1215000,157000,1372000
2023,District of Oak Bay,07-2463-00,V6Z 2S6,,2024 NEWTON,1048200,1083000,53800,1136800
2023,District of Oak Bay,07-2464-00,V8R 2R8,,2030 NEWTON,1184000,1083000,201000,1284000
2023,District of Oak Bay,07-2465-00,V8R 2R8,,2036 NEWTON,1216000,1083000,234000,1317000
2023,District of Oak Bay,07-2466-00,V8R 2R8,,2042 NEWTON,1036700,1083000,49400,1132400
2023,District of Oak Bay,07-2467-00,V8R 2R8,,2048 NEWTON,1184000,1083000,186000,1269000
2023,District of Oak Bay,07-2468-00,V8R 2R8,,2054 NEWTON,1051300,1083000,59400,1142400
2023,District of Oak Bay,07-2469-00,V0R 1L4,,2060 NEWTON,1117000,1083000,131000,1214000
2023,District of Oak Bay,07-2470-00,V8R 2R8,,2066 NEWTON,1136000,1083000,146000,1229000
2023,District of Oak Bay,07-2471-00,T3B 6A3,,2072 NEWTON,1084400,1083000,90000,1173000
2023,District of Oak Bay,07-2472-00,V8R 2R8,,2078 NEWTON,1137000,1083000,157000,1240000
2023,District of Oak Bay,07-2473-00,V8R 2N1,,2084 NEWTON,1032300,1083000,45800,1128800
2023,District of Oak Bay,07-2474-00,V8R 2R8,,2088 NEWTON,1428000,1263000,299000,1562000
2023,District of Oak Bay,07-2475-00,V8R 5B6,,2727 FOUL BAY,902000,869000,111000,980000
2023,District of Oak Bay,07-2476-00,V8S 4L8,,2723 FOUL BAY,854200,849000,77800,926800
2023,District of Oak Bay,07-2477-00,V8R 5B6,,2719 FOUL BAY,892000,849000,120000,969000
2023,District of Oak Bay,07-2478-00,V8R 5B6,,2713 FOUL BAY,967000,849000,202000,1051000
2023,District of Oak Bay,07-2479-00,V8R 5B6,,2707 FOUL BAY,911000,849000,143000,992000
2023,District of Oak Bay,07-2479-00,V9A 3V9,,2707 FOUL BAY,911000,849000,143000,992000
2023,District of Oak Bay,07-2480-00,V8R 2R7,,2023 NEWTON,1204000,1083000,216000,1299000
2023,District of Oak Bay,07-2481-00,V8R 2R7,,2029 NEWTON,1161000,1083000,173000,1256000
2023,District of Oak Bay,07-2482-00,V8R 2R7,,2035 NEWTON,1333000,1083000,363000,1446000
2023,District of Oak Bay,07-2483-00,V8R 2R7,,2041 NEWTON,1157000,1083000,173000,1256000
2023,District of Oak Bay,07-2484-00,V8R 2R7,,2047 NEWTON,1229000,1083000,248000,1331000
2023,District of Oak Bay,07-2485-00,V8R 2R7,,2053 NEWTON,1151000,1083000,167000,1250000
2023,District of Oak Bay,07-2486-00,V8R 2R7,,2059 NEWTON,1091100,1083000,116000,1199000
2023,District of Oak Bay,07-2487-00,V8R 2R7,,2065 NEWTON,1153000,1083000,169000,1252000
2023,District of Oak Bay,07-2488-00,V8W 1L1,,2071 NEWTON,1152000,1083000,163000,1246000
2023,District of Oak Bay,07-2489-00,V8R 2R7,,2077 NEWTON,1174000,1083000,196000,1279000
2023,District of Oak Bay,07-2490-00,V8X 1E6,,2083 NEWTON,2361000,1084000,1621000,2705000
2023,District of Oak Bay,07-2491-00,V8R 2R7,,2091 NEWTON,1849000,1334000,736000,2070000
2023,District of Oak Bay,07-2492-00,V8X 3L7,,2022 KINGS,1135000,1083000,151000,1234000
2023,District of Oak Bay,07-2493-00,V8R 2P7,,2028 KINGS,1114000,1083000,127000,1210000
2023,District of Oak Bay,07-2494-00,V8R 2P7,,2034 KINGS,1151000,1083000,155000,1238000
2023,District of Oak Bay,07-2495-00,V8R 2P7,,2040 KINGS,1293000,1083000,298000,1381000
2023,District of Oak Bay,07-2496-00,V8S 2K8,,2046 KINGS,1057000,1083000,62000,1145000
2023,District of Oak Bay,07-2497-00,V6Z 2Y2,,2052 KINGS,1116000,1083000,129000,1212000
2023,District of Oak Bay,07-2498-00,V8R 2P7,,2058 KINGS,1140000,1083000,148000,1231000
2023,District of Oak Bay,07-2499-00,V8S 2W7,,2064 KINGS,1109000,1083000,117000,1200000
2023,District of Oak Bay,07-2500-00,V8R 2P7,,2070 KINGS,1124000,1083000,137000,1220000
2023,District of Oak Bay,07-2501-00,V8R 2P7,,2076 KINGS,1157000,1083000,169000,1252000
2023,District of Oak Bay,07-2502-00,V8R 2P7,,2082 KINGS,1528000,1084000,562000,1646000
2023,District of Oak Bay,07-2503-00,V8R 2P7,,2090 KINGS,2594000,1377000,1517000,2894000
2023,District of Oak Bay,07-2504-00,V5P 1B6,,2019 KINGS,949000,887000,145000,1032000
2023,District of Oak Bay,07-2505-00,V8R 5B5,,2681 FOUL BAY,998000,887000,184000,1071000
2023,District of Oak Bay,07-2506-00,V8R 5B5,,2673 FOUL BAY,985000,886000,180000,1066000
2023,District of Oak Bay,07-2507-00,V8R 5B5,,2665 FOUL BAY,1044000,887000,233000,1120000
2023,District of Oak Bay,07-2508-00,V8R 2M6,,2002 CARRICK,939000,875000,139000,1014000
2023,District of Oak Bay,07-2509-00,V8R 2P6,,2021 KINGS,1225000,1123000,170000,1293000
2023,District of Oak Bay,07-2510-00,V8R 2P6,,2027 KINGS,1152000,1124000,130000,1254000
2023,District of Oak Bay,07-2511-00,V8R 2P6,,2033 KINGS,1165000,1124000,143000,1267000
2023,District of Oak Bay,07-2512-00,V8R 2P6,,2039 KINGS,1133000,1124000,109000,1233000
2023,District of Oak Bay,07-2513-00,V8R 2P6,,2045 KINGS,1082700,1124000,60400,1184400
2023,District of Oak Bay,07-2514-00,V8R 2P6,,2051 KINGS,1158000,1124000,136000,1260000
2023,District of Oak Bay,07-2515-00,T2N 4E4,,2057 KINGS,1184000,1124000,166000,1290000
2023,District of Oak Bay,07-2515-00,V8V 4Y4,,2057 KINGS,1184000,1124000,166000,1290000
2023,District of Oak Bay,07-2516-00,V8R 2P6,,2063 KINGS,1219000,1124000,198000,1322000
2023,District of Oak Bay,07-2517-00,V0J 2N4,,2069 KINGS,1160000,1124000,134000,1258000
2023,District of Oak Bay,07-2517-00,V8R 2P6,,2069 KINGS,1160000,1124000,134000,1258000
2023,District of Oak Bay,07-2518-00,V8R 2P6,,2075 KINGS,1158000,1124000,150000,1274000
2023,District of Oak Bay,07-2519-00,V8R 2P6,,2081 KINGS,1212000,1124000,194000,1318000
2023,District of Oak Bay,07-2520-00,V8R 2P6,,2083 KINGS,1461000,1124000,500000,1624000
2023,District of Oak Bay,07-2521-00,V8R 2P6,,2091 KINGS,1300000,1163000,247000,1410000
2023,District of Oak Bay,07-2522-00,V8R 2M6,,2022 CARRICK,1008000,1012000,88700,1100700
2023,District of Oak Bay,07-2523-00,V8R 2M6,,2028 CARRICK,1768000,1123000,858000,1981000
2023,District of Oak Bay,07-2524-00,V8R 2M6,,2034 CARRICK,1147000,1124000,130000,1254000
2023,District of Oak Bay,07-2524-00,V8R 2M6,,2034 CARRICK,1147000,1124000,130000,1254000
2023,District of Oak Bay,07-2525-00,V8R 2M6,,2040 CARRICK,1258000,1124000,239000,1363000
2023,District of Oak Bay,07-2526-00,V8R 2M6,,2046 CARRICK,1193000,1124000,175000,1299000
2023,District of Oak Bay,07-2527-00,V8R 2M6,,2048 CARRICK,1160000,1124000,139000,1263000
2023,District of Oak Bay,07-2528-00,V8R 2M6,,2052 CARRICK,1479000,1124000,533000,1657000
2023,District of Oak Bay,07-2529-00,V8R 2M6,,2056 CARRICK,1098900,1124000,81400,1205400
2023,District of Oak Bay,07-2530-00,V8N 2G2,,2060 CARRICK,1081000,1124000,59500,1183500
2023,District of Oak Bay,07-2531-00,V4T 1X1,,2064 CARRICK,1176000,1124000,156000,1280000
2023,District of Oak Bay,07-2532-00,V8R 2M6,,2070 CARRICK,1161000,1124000,155000,1279000
2023,District of Oak Bay,07-2533-00,V8R 2M6,,2080 CARRICK,1245000,1124000,235000,1359000
2023,District of Oak Bay,07-2534-00,V8R 2M6,,2090 CARRICK,1555000,1224000,461000,1685000
2023,District of Oak Bay,07-2535-00,V8R 2M5,,2001 CARRICK,1002000,868000,217000,1085000
2023,District of Oak Bay,07-2535-00,V8R 2M5,,2001 CARRICK,1002000,868000,217000,1085000
2023,District of Oak Bay,07-2536-00,V8R 5B3,,2633 FOUL BAY,965000,868000,175000,1043000
2023,District of Oak Bay,07-2537-00,V8N 6L3,,2625 FOUL BAY,1218000,868000,469000,1337000
2023,District of Oak Bay,07-2538-00,V8R 5B3,,2617 FOUL BAY,890900,868000,94000,962000
2023,District of Oak Bay,07-2539-00,V8R 5B3,,2609 FOUL BAY,950000,868000,188000,1056000
2023,District of Oak Bay,07-2540-00,V8R 2M5,,2021 CARRICK,1134000,1102000,130000,1232000
2023,District of Oak Bay,07-2541-00,V8R 6K6,,2027 CARRICK,1218000,1102000,217000,1319000
2023,District of Oak Bay,07-2542-00,V8R 2M5,,2033 CARRICK,1081900,1102000,71800,1173800
2023,District of Oak Bay,07-2549-00,V8S 2X7,,2071 CARRICK,1165000,1100000,165000,1265000
2023,District of Oak Bay,07-2550-00,V8R 2M5,,2081 CARRICK,1144000,1100000,133000,1233000
2023,District of Oak Bay,07-2551-00,V8R 2M5,,2091 CARRICK,1232300,1278000,60100,1338100
2023,District of Oak Bay,07-2552-00,V8R 2L7,,2022 HAULTAIN,1030900,1014000,100000,1114000
2023,District of Oak Bay,07-2553-00,V8K 1E2,,2028 HAULTAIN,1021800,1014000,106000,1120000
2023,District of Oak Bay,07-2553-00,V8R 2L7,,2028 HAULTAIN,1021800,1014000,106000,1120000
2023,District of Oak Bay,07-2554-00,V8R 2L7,,2034 HAULTAIN,1097000,1013000,178000,1191000
2023,District of Oak Bay,07-2561-00,V8R 5T8,,2074 HAULTAIN,1050000,1013000,129000,1142000
2023,District of Oak Bay,07-2562-00,V8R 2L7,,2082 HAULTAIN,1239000,1086000,256000,1342000
2023,District of Oak Bay,07-2563-00,V8R 2L7,,2092 HAULTAIN,1410000,1160000,364000,1524000
2023,District of Oak Bay,07-2565-00,V8R 5C7,,2925 FOUL BAY,951000,850000,184000,1034000
2023,District of Oak Bay,07-2565-00,V8Z 7A9,,2925 FOUL BAY,951000,850000,184000,1034000
2023,District of Oak Bay,07-2566-00,V8R 5C7,,2917 FOUL BAY,1007000,850000,247000,1097000
2023,District of Oak Bay,07-2567-00,V8N 3W3,,2909 FOUL BAY,906000,850000,136000,986000
2023,District of Oak Bay,07-2568-00,V8R 3E2,,2026 NEIL,1113000,1062000,153000,1215000
2023,District of Oak Bay,07-2569-00,V8R 3E2,,2032 NEIL,1125000,1062000,153000,1215000
2023,District of Oak Bay,07-2570-00,V8R 3E2,,2038 NEIL,1136000,1009000,225000,1234000
2023,District of Oak Bay,07-2571-00,V8R 3E2,,2044 NEIL,1058000,1009000,165000,1174000
2023,District of Oak Bay,07-2572-00,V8R 3E2,,2050 NEIL,1129000,1062000,171000,1233000
2023,District of Oak Bay,07-2573-00,V8R 3E2,,2058 NEIL,1095000,1062000,133000,1195000
2023,District of Oak Bay,07-2574-00,V8N 4M6,,2064 NEIL,1062600,1062000,95000,1157000
2023,District of Oak Bay,07-2575-00,V8R 3E2,,2072 NEIL,1066700,1062000,137000,1199000
2023,District of Oak Bay,07-2576-00,V8R 3E2,,2078 NEIL,1084000,1062000,112000,1174000
2023,District of Oak Bay,07-2577-00,V8R 3K8,,2084 NEIL,1082000,1062000,116000,1178000
2023,District of Oak Bay,07-2581-00,V8R 3E2,,2040 NEIL,1343000,863000,618000,1481000
2023,District of Oak Bay,07-2582-00,V8R 3E2,,2042 NEIL,1313000,847000,599000,1446000
2023,District of Oak Bay,07-2583-00,V8R 3E2,, NEIL,64700,69900,0,69900
2023,District of Oak Bay,07-2584-00,V8R 3E2,, NEIL,63500,68600,0,68600
2023,District of Oak Bay,07-2585-00,V8N 4M6,, NEIL,62100,67200,0,67200
2023,District of Oak Bay,07-2586-00,V8R 3E2,,2074 NEIL,60700,65900,0,65900
2023,District of Oak Bay,07-2601-00,V8R 5C3,,2841 FOUL BAY,1014000,977000,126000,1103000
2023,District of Oak Bay,07-2602-00,V8R 5C3,,2829 FOUL BAY,1130000,977000,222000,1199000
2023,District of Oak Bay,07-2603-00,V8R 5C3,,2817 FOUL BAY,1131000,836000,418000,1254000
2023,District of Oak Bay,07-2604-00,V5V 2A6,,2809 FOUL BAY,834000,836000,82400,918400
2023,District of Oak Bay,07-2617-00,V8R 3B4,,2024 TOWNLEY,2645000,1240000,1778000,3018000
2023,District of Oak Bay,07-2618-00,V8R 3B4,,2036 TOWNLEY,1329000,1240000,194000,1434000
2023,District of Oak Bay,07-2619-00,V8R 3B4,,2042 TOWNLEY,1087000,1062000,120000,1182000
2023,District of Oak Bay,07-2620-00,V8R 3B4,,2048 TOWNLEY,1088000,1062000,121000,1183000
2023,District of Oak Bay,07-2621-00,V8R 3B4,,2054 TOWNLEY,1134000,1063000,185000,1248000
2023,District of Oak Bay,07-2622-00,V9R 3B4,,2060 TOWNLEY,1054500,1062000,87000,1149000
2023,District of Oak Bay,07-2622-00,V8R 2X9,,2060 TOWNLEY,1054500,1062000,87000,1149000
2023,District of Oak Bay,07-2623-00,V8R 3B4,,2066 TOWNLEY,1130000,1063000,162000,1225000
2023,District of Oak Bay,07-2624-00,V8R 3B4,,2072 TOWNLEY,1020900,1063000,50200,1113200
2023,District of Oak Bay,07-2625-00,V8R 3B4,,2078 TOWNLEY,1158000,1139000,119000,1258000
2023,District of Oak Bay,07-2626-00,V8N 5X3,,2084 TOWNLEY,1347000,1269000,217000,1486000
2023,District of Oak Bay,07-2627-00,V8R 5C1,,2795 FOUL BAY,991000,911000,158000,1069000
2023,District of Oak Bay,07-2628-00,V8R 3B3,,2023 TOWNLEY,1093000,1062000,127000,1189000
2023,District of Oak Bay,07-2629-00,V8R 3B3,,2029 TOWNLEY,1019300,1062000,49200,1111200
2023,District of Oak Bay,07-2630-00,V8R 3B3,,2035 TOWNLEY,1089000,1062000,124000,1186000
2023,District of Oak Bay,07-2631-00,V8R 3B3,,2041 TOWNLEY,1153000,1062000,190000,1252000
2023,District of Oak Bay,07-2632-00,V8R 3B3,,2045 TOWNLEY,1242000,1062000,302000,1364000
2023,District of Oak Bay,07-2632-05,V8R 3B3,,2053 TOWNLEY,1305000,1062000,356000,1418000
2023,District of Oak Bay,07-2633-00,V8R 3B3,,2057 TOWNLEY,1261000,1240000,129000,1369000
2023,District of Oak Bay,07-2634-00,V8R 3B3,,2071 TOWNLEY,1336000,1240000,214000,1454000
2023,District of Oak Bay,07-2635-00,V8R 3B3,,2077 TOWNLEY,1093000,1062000,128000,1190000
2023,District of Oak Bay,07-2636-00,V8R 3B3,,2083 TOWNLEY,1109000,1062000,140000,1202000
2023,District of Oak Bay,07-2637-00,V8R 3B3,,2091 TOWNLEY,1327000,1064000,382000,1446000
2023,District of Oak Bay,07-2638-00,V8R 2V3,,2024 CARNARVON,1028000,1062000,61700,1123700
2023,District of Oak Bay,07-2639-00,V8R 2V3,,2030 CARNARVON,1221000,1061000,257000,1318000
2023,District of Oak Bay,07-2640-00,V8R 2V3,,2036 CARNARVON,1148000,1061000,186000,1247000
2023,District of Oak Bay,07-2641-00,V8R 2V3,,2042 CARNARVON,2229000,1062000,1481000,2543000
2023,District of Oak Bay,07-2642-00,V8R 2V3,,2048 CARNARVON,1106000,1062000,141000,1203000
2023,District of Oak Bay,07-2643-00,V8R 2V3,,2054 CARNARVON,1021600,1061000,58100,1119100
2023,District of Oak Bay,07-2644-00,V8R 2V3,,2060 CARNARVON,1143000,1062000,186000,1248000
2023,District of Oak Bay,07-2645-00,V8R 2V3,,2066 CARNARVON,1058500,1061000,91600,1152600
2023,District of Oak Bay,07-2646-00,V8R 2V3,,2072 CARNARVON,1072600,1062000,111000,1173000
2023,District of Oak Bay,07-2647-00,V8R 2V3,,2078 CARNARVON,1129000,1062000,166000,1228000
2023,District of Oak Bay,07-2648-00,V8X 5C7,,2084 CARNARVON,1030300,1061000,57900,1118900
2023,District of Oak Bay,07-2649-00,V8R 2V3,,2090 CARNARVON,1881000,1117000,961000,2078000
2023,District of Oak Bay,07-2650-00,V8R 5W2,,1596 CLIVE,1214400,1263000,61200,1324200
2023,District of Oak Bay,07-2651-00,V8R 5W2,,1584 CLIVE,1222000,1119000,202000,1321000
2023,District of Oak Bay,07-2652-00,V8R 5W2,,1578 CLIVE,1155000,1119000,161000,1280000
2023,District of Oak Bay,07-2653-00,V8R 5W2,,1568 CLIVE,1163000,1119000,146000,1265000
2023,District of Oak Bay,07-2654-00,V8R 5W2,,1560 CLIVE,1175000,1119000,159000,1278000
2023,District of Oak Bay,07-2654-00,V8R 1P1,,1560 CLIVE,1175000,1119000,159000,1278000
2023,District of Oak Bay,07-2655-00,V8R 5W2,,1552 CLIVE,1777000,1120000,1261000,2381000
2023,District of Oak Bay,07-2656-00,V8R 5W2,,1544 CLIVE,1071700,1119000,54600,1173600
2023,District of Oak Bay,07-2657-00,V8R 5W2,,1536 CLIVE,1495000,1119000,542000,1661000
2023,District of Oak Bay,07-2658-00,K1N 0C4,,1530 CLIVE,1085200,1123000,63300,1186300
2023,District of Oak Bay,07-2659-01,V8V 2P5,,1510 CLIVE,8847000,2280000,7507000,9787000
2023,District of Oak Bay,07-2660-00,V8R 5W3,,1595 CLIVE,1642000,1154000,646000,1800000
2023,District of Oak Bay,07-2661-00,V8R 5W3,,1587 CLIVE,1200000,1147000,155000,1302000
2023,District of Oak Bay,07-2662-00,V8R 5W3,,1579 CLIVE,1644000,1147000,685000,1832000
2023,District of Oak Bay,07-2663-00,V8R 5W3,,1571 CLIVE,1599000,1147000,580000,1727000
2023,District of Oak Bay,07-2664-00,V8R 5W3,,1563 CLIVE,1316000,1305000,131000,1436000
2023,District of Oak Bay,07-2664-01,V8R 5W3,,1553 CLIVE,1223000,1153000,180000,1333000
2023,District of Oak Bay,07-2665-00,V8R 5W3,,1545 CLIVE,1164000,1141000,124000,1265000
2023,District of Oak Bay,07-2666-00,V8R 5W3,,1537 CLIVE,1115100,1147000,65100,1212100
2023,District of Oak Bay,07-2667-00,V8R 5W3,,1527 CLIVE,1579000,1316000,405000,1721000
2023,District of Oak Bay,07-2670-00,V8S 4N6,,989 VICTORIA,1245000,1117000,213000,1330000
2023,District of Oak Bay,07-2671-00,V8S 4N6,,977 VICTORIA,1247000,1172000,165000,1337000
2023,District of Oak Bay,07-2672-00,V8S 4N6,,965 VICTORIA,1230000,1172000,143000,1315000
2023,District of Oak Bay,07-2673-00,V8S 4N6,,953 VICTORIA,1399000,1172000,329000,1501000
2023,District of Oak Bay,07-2674-00,V8S 4N6,,941 VICTORIA,1113600,1172000,24800,1196800
2023,District of Oak Bay,07-2675-00,V8S 4N6,,929 VICTORIA,1226000,1172000,142000,1314000
2023,District of Oak Bay,07-2676-00,V8S 2Y4,,2169 MCNEILL,1274000,1226000,141000,1367000
2023,District of Oak Bay,07-2677-00,V8S 2Y4,,2175 MCNEILL,1247000,1227000,111000,1338000
2023,District of Oak Bay,07-2678-00,V8S 2Y4,,2183 MCNEILL,1353000,1226000,220000,1446000
2023,District of Oak Bay,07-2678-01,V8S 2Y4,,2189 MCNEILL,1378000,1226000,250000,1476000
2023,District of Oak Bay,07-2679-00,V8S 2W6,,2170 PENTLAND,1381000,1289000,184000,1473000
2023,District of Oak Bay,07-2680-00,V8S 2W6,,2176 PENTLAND,1437000,1289000,252000,1541000
2023,District of Oak Bay,07-2681-00,V8S 2W6,,2180 PENTLAND,1412000,1289000,227000,1516000
2023,District of Oak Bay,07-2682-00,V8S 2W6,,2184 PENTLAND,1852000,1289000,770000,2059000
2023,District of Oak Bay,07-2683-00,V6H 1K2,,990 HAMPSHIRE,1168000,1117000,139000,1256000
2023,District of Oak Bay,07-2683-00,V8S 4S7,,990 HAMPSHIRE,1168000,1117000,139000,1256000
2023,District of Oak Bay,07-2684-00,V8S 4S7,,978 HAMPSHIRE,1233000,1172000,151000,1323000
2023,District of Oak Bay,07-2685-00,V8S 4S7,,966 HAMPSHIRE,1215000,1172000,129000,1301000
2023,District of Oak Bay,07-2686-00,V8S 4S7,,954 HAMPSHIRE,1145800,1172000,63300,1235300
2023,District of Oak Bay,07-2687-00,V8S 4L8,,942 HAMPSHIRE,1256000,1172000,174000,1346000
2023,District of Oak Bay,07-2688-00,V8S 4S7,,930 HAMPSHIRE,1208000,1172000,119000,1291000
2023,District of Oak Bay,07-2689-00,V8S 4V3,,957 MONTEREY,1511000,1239000,410000,1649000
2023,District of Oak Bay,07-2690-00,V8S 4V3,,947 MONTEREY,1543000,1239000,417000,1656000
2023,District of Oak Bay,07-2691-00,V8S 2Y7,,2245 MCNEILL,1217000,1136000,174000,1310000
2023,District of Oak Bay,07-2692-00,V8S 2Y7,,2253 MCNEILL,1246000,1136000,203000,1339000
2023,District of Oak Bay,07-2693-00,V8S 2Y7,,2265 MCNEILL,1307000,1136000,265000,1401000
2023,District of Oak Bay,07-2694-00,V8S 3A2,,2252 TINTO,1254000,1194000,150000,1344000
2023,District of Oak Bay,07-2695-00,V8S 3A2,,2266 TINTO,2199000,1193000,1244000,2437000
2023,District of Oak Bay,07-2696-00,V8S 3A2,,2270 TINTO,1268000,1193000,165000,1358000
2023,District of Oak Bay,07-2697-00,V8Z 1E8,,925 MONTEREY,570000,665000,0,665000
2023,District of Oak Bay,07-2698-00,V8Z 1E8,,923 MONTEREY,545000,636000,0,636000
2023,District of Oak Bay,07-2699-00,V8R 1G2,, MONTEREY,545000,636000,0,636000
2023,District of Oak Bay,07-2700-00,V8R 1G2,, MONTEREY,545000,636000,0,636000
2023,District of Oak Bay,07-2701-00,V8Z 1E8,,2259 TINTO,504000,584000,0,584000
2023,District of Oak Bay,07-2702-00,V8Z 1E8,,2265 TINTO,504000,584000,0,584000
2023,District of Oak Bay,07-2703-00,V8Z 1E8,,2271 TINTO,504000,584000,0,584000
2023,District of Oak Bay,07-2704-00,V8R 1G2,, TINTO,275000,319000,0,319000
2023,District of Oak Bay,07-2705-00,V8R 1G2,, MONTEREY,275000,319000,0,319000
2023,District of Oak Bay,07-2706-00,V8R 1G2,, MONTEREY,275000,319000,0,319000
2023,District of Oak Bay,07-2707-00,V8R 1G2,, MONTEREY,941000,1086000,0,1086000
2023,District of Oak Bay,07-2709-00,V8R 1G2,,851 MONTEREY,10756000,2577000,9681000,12258000
2023,District of Oak Bay,07-2709-00,V8R 1G2,,851 MONTEREY,10756000,2577000,9681000,12258000
2023,District of Oak Bay,07-2709-00,V8R 1G2,,851 MONTEREY,10756000,2577000,9681000,12258000
2023,District of Oak Bay,07-2709-00,V8R 1G2,,851 MONTEREY,10756000,2577000,9681000,12258000
2023,District of Oak Bay,07-2709-00,V8R 1G2,,851 MONTEREY,10756000,2577000,9681000,12258000
2023,District of Oak Bay,07-2709-00,V8R 1G2,,851 MONTEREY,10756000,2577000,9681000,12258000
2023,District of Oak Bay,07-2709-00,V8R 1G2,,851 MONTEREY,10756000,2577000,9681000,12258000
2023,District of Oak Bay,07-2709-00,V8R 1G2,,851 MONTEREY,10756000,2577000,9681000,12258000
2023,District of Oak Bay,07-2710-00,V8R 1G2,, MONTEREY,504000,584000,0,584000
2023,District of Oak Bay,07-2711-00,V8R 1G2,, MONTEREY,504000,584000,0,584000
2023,District of Oak Bay,07-2713-00,V8Z 1E8,, MONTEREY,545000,636000,0,636000
2023,District of Oak Bay,07-2714-00,V8Z 1E8,, MONTEREY,545000,636000,0,636000
2023,District of Oak Bay,07-2715-00,V8S 2V1,,907 ISLAND,1784000,1486000,440000,1926000
2023,District of Oak Bay,07-2716-00,V8S 2V1,,901 ISLAND,2147000,1486000,852000,2338000
2023,District of Oak Bay,07-2719-00,V8S 5B4,,900 BYNG,2528000,1423000,1451000,2874000
2023,District of Oak Bay,07-2719-01,V8S 5B4,,908 BYNG,2572000,1423000,1486000,2909000
2023,District of Oak Bay,07-2720-00,V8S 2V1,,877 ISLAND,1250000,1175000,164000,1339000
2023,District of Oak Bay,07-2721-00,V8S 2X5,,2458 HAZEL,1836000,1175000,828000,2003000
2023,District of Oak Bay,07-2722-00,V8S 2X5,,2464 HAZEL,1220000,1175000,134000,1309000
2023,District of Oak Bay,07-2728-00,V8S 2X5,,2488 HAZEL,1906000,1373000,740000,2113000
2023,District of Oak Bay,07-2728-00,V8S 2X5,,2488 HAZEL,1906000,1373000,740000,2113000
2023,District of Oak Bay,07-2729-00,V8S 5B4,,880 BYNG,1292000,1190000,203000,1393000
2023,District of Oak Bay,07-2730-00,V8S 2T8,,835 ISLAND,1376000,1176000,311000,1487000
2023,District of Oak Bay,07-2731-00,V8S 2X6,,2461 HAZEL,1159400,1176000,66800,1242800
2023,District of Oak Bay,07-2732-01,V8S 2X6,,2465 HAZEL,1397000,1177000,338000,1515000
2023,District of Oak Bay,07-2732-02,V8S 2X6,,2467 HAZEL,1396000,1177000,337000,1514000
2023,District of Oak Bay,07-2733-00,V0E 1B4,,2473 HAZEL,1163800,1177000,66900,1243900
2023,District of Oak Bay,07-2734-00,V8N 1Y9,,2479 HAZEL,1237000,1177000,630000,1807000
2023,District of Oak Bay,07-2735-00,V8S 2X6,,2483 HAZEL,1294000,1178000,210000,1388000
2023,District of Oak Bay,07-2736-00,V8S 2X6,,2489 HAZEL,1285000,1178000,203000,1381000
2023,District of Oak Bay,07-2737-00,V8S 5B3,,830 BYNG,1373000,1245000,239000,1484000
2023,District of Oak Bay,08-2738-00,V8S 4T8,,697 MONTEREY,1343000,1280000,158000,1438000
2023,District of Oak Bay,08-2739-00,V8S 4T8,,675 MONTEREY,1289000,1239000,168000,1407000
2023,District of Oak Bay,08-2740-00,V8S 4T8,,663 MONTEREY,1505000,1473000,139000,1612000
2023,District of Oak Bay,08-2741-00,V8S 2S1,,2259 CENTRAL,1239000,1215000,108000,1323000
2023,District of Oak Bay,08-2742-00,V8S 2S1,,2263 CENTRAL,1562000,1411000,268000,1679000
2023,District of Oak Bay,08-2743-00,M5V 1A8,,2267 CENTRAL,2573000,1410000,1483000,2893000
2023,District of Oak Bay,08-2744-00,V8S 4T8,,651 MONTEREY,1807000,1686000,285000,1971000
2023,District of Oak Bay,08-2745-00,V8S 4T8,,639 MONTEREY,1719000,1686000,153000,1839000
2023,District of Oak Bay,08-2746-00,V8S 4T8,,627 MONTEREY,1550900,1595000,76500,1671500
2023,District of Oak Bay,08-2747-00,V8S 4N3,,732 VICTORIA,1479000,1410000,182000,1592000
2023,District of Oak Bay,08-2747-00,V8P 4A2,,732 VICTORIA,1479000,1410000,182000,1592000
2023,District of Oak Bay,08-2748-00,V8S 2R3,,2138 CENTRAL,1504000,1412000,225000,1637000
2023,District of Oak Bay,08-2749-00,V8S 4N3,,740 VICTORIA,1593000,1318000,403000,1721000
2023,District of Oak Bay,08-2750-00,V8S 4N3,,752 VICTORIA,1449000,1279000,296000,1575000
2023,District of Oak Bay,08-2751-00,V8S 4N3,,762 VICTORIA,2679000,1265000,1839000,3104000
2023,District of Oak Bay,08-2752-00,V8S 2R5,,2172 CENTRAL,1417000,1465000,52600,1517600
2023,District of Oak Bay,08-2753-00,V8S 2R5,,2178 CENTRAL,1546000,1539000,117000,1656000
2023,District of Oak Bay,08-2754-00,V8S 2R5,,2184 CENTRAL,1704000,1299000,559000,1858000
2023,District of Oak Bay,08-2755-00,V8S 2R5,,2188 CENTRAL,2333000,1299000,1318000,2617000
2023,District of Oak Bay,08-2756-00,V8S 2R5,,2194 CENTRAL,1328000,1300000,128000,1428000
2023,District of Oak Bay,08-2757-00,V8S 4S4,,742 HAMPSHIRE,1560000,1345000,346000,1691000
2023,District of Oak Bay,08-2758-00,V8S 4S4,,752 HAMPSHIRE,1832000,1345000,662000,2007000
2023,District of Oak Bay,08-2759-00,V8S 4S4,,762 HAMPSHIRE,1440000,1345000,206000,1551000
2023,District of Oak Bay,08-2760-00,V8S 4N2,,767 VICTORIA,1282000,1229000,144000,1373000
2023,District of Oak Bay,08-2761-00,V8S 4N2,,755 VICTORIA,1299000,1242000,157000,1399000
2023,District of Oak Bay,08-2762-00,V8S 4N2,,743 VICTORIA,1423000,1281000,245000,1526000
2023,District of Oak Bay,08-2763-00,V8S 4N2,,731 VICTORIA,1297000,1238000,155000,1393000
2023,District of Oak Bay,08-2764-00,V8S 2R5,,2162 CENTRAL,1238200,1238000,88000,1326000
2023,District of Oak Bay,08-2765-00,V8S 2R5,,2166 CENTRAL,1436000,1238000,318000,1556000
2023,District of Oak Bay,08-2767-00,V8R 6K6,,1439 MITCHELL,1082000,1034000,141000,1175000
2023,District of Oak Bay,08-2768-00,V8R 6K6,,1429 MITCHELL,1093700,1094000,81900,1175900
2023,District of Oak Bay,08-2769-00,V8T 4K5,,1421 MITCHELL,1094300,1094000,88700,1182700
2023,District of Oak Bay,08-2770-00,V8S 4R1,,1411 MITCHELL,1109000,1065000,139000,1204000
2023,District of Oak Bay,08-2771-00,V8S 4X1,,1239 OLIVER,1616000,1407000,339000,1746000
2023,District of Oak Bay,08-2772-00,V8S 4Y4,,1238 ST. PATRICK,1482000,1406000,182000,1588000
2023,District of Oak Bay,08-2773-00,V8S 4Y4,,1250 ST. PATRICK,1623000,1408000,339000,1747000
2023,District of Oak Bay,08-2774-00,V8S 4Y4,,1258 ST. PATRICK,1448000,1406000,161000,1567000
2023,District of Oak Bay,08-2775-00,V8S 3B2,,2609 ORCHARD,1325000,1270000,151000,1421000
2023,District of Oak Bay,08-2776-00,V8S 3B2,,2617 ORCHARD,1267000,1224000,135000,1359000
2023,District of Oak Bay,08-2777-00,V8S 3B2,,2625 ORCHARD,1351000,1224000,221000,1445000
2023,District of Oak Bay,08-2778-00,V8S 3B2,,2633 ORCHARD,1263000,1224000,131000,1355000
2023,District of Oak Bay,08-2778-00,V9A 2P1,,2633 ORCHARD,1263000,1224000,131000,1355000
2023,District of Oak Bay,08-2778-00,V6K 1C5,,2633 ORCHARD,1263000,1224000,131000,1355000
2023,District of Oak Bay,08-2778-00,S7H 2C3,,2633 ORCHARD,1263000,1224000,131000,1355000
2023,District of Oak Bay,08-2779-00,V8S 3B2,,2641 ORCHARD,1383000,1270000,206000,1476000
2023,District of Oak Bay,08-2780-00,V8S 5G5,,1078 DEAL,1399000,1324000,197000,1521000
2023,District of Oak Bay,08-2781-00,V8S 5G5,,1072 DEAL,1901000,1323000,731000,2054000
2023,District of Oak Bay,08-2782-00,V8X 3V7,,1064 DEAL,1305900,1324000,80500,1404500
2023,District of Oak Bay,08-2783-00,V8S 5G5,,1056 DEAL,1581000,1324000,381000,1705000
2023,District of Oak Bay,08-2784-00,V8S 5G5,,1050 DEAL,1498900,1545000,65100,1610100
2023,District of Oak Bay,08-2784-00,V8S 5G5,,1050 DEAL,1498900,1545000,65100,1610100
2023,District of Oak Bay,08-2788-00,V8S 5E2,,1053 NEWPORT,1464000,1390000,182000,1572000
2023,District of Oak Bay,08-2789-00,V8S 5E2,,1063 NEWPORT,1506000,1390000,228000,1618000
2023,District of Oak Bay,08-2790-00,V8S 5E2,,1073 NEWPORT,1717000,1390000,497000,1887000
2023,District of Oak Bay,08-2791-00,V8S 3A9,,2545 ORCHARD,1408000,1326000,177000,1503000
2023,District of Oak Bay,08-2792-00,V8S 3A9,,2531 ORCHARD,1539000,1326000,341000,1667000
2023,District of Oak Bay,08-2793-00,V8S 3A9,,2519 ORCHARD,1465000,1326000,234000,1560000
2023,District of Oak Bay,08-2794-00,V8S 3A9,,2503 ORCHARD,1843000,1632000,354000,1986000
2023,District of Oak Bay,08-2796-00,V8V 3K8,,1052 NEWPORT,3060000,1746000,1711000,3457000
2023,District of Oak Bay,08-2796-00,V8V 3K8,,1052 NEWPORT,3060000,1746000,1711000,3457000
2023,District of Oak Bay,08-2798-00,V8P 2L5,,1072 NEWPORT,2029000,1344000,866000,2210000
2023,District of Oak Bay,08-2799-00,V8S 5E3,,1082 NEWPORT,1509000,1344000,258000,1602000
2023,District of Oak Bay,08-2800-00,V8S 5E3,,1092 NEWPORT,1737000,1345000,559000,1904000
2023,District of Oak Bay,08-2801-00,V8S 3B7,,2559 CURRIE,1553000,1344000,331000,1675000
2023,District of Oak Bay,08-2802-00,V8S 3B7,,2549 CURRIE,1541000,1344000,317000,1661000
2023,District of Oak Bay,08-2803-00,V8S 3B7,,2539 CURRIE,1923000,1344000,747000,2091000
2023,District of Oak Bay,08-2804-00,V8S 3B7,,2519 CURRIE,2423000,1571000,1061000,2632000
2023,District of Oak Bay,08-2805-00,V8S 3B1,,2518 ORCHARD,1289000,1205000,203000,1408000
2023,District of Oak Bay,08-2806-00,V8S 3B1,,2508 ORCHARD,1443000,1206000,370000,1576000
2023,District of Oak Bay,08-2807-00,V8S 3B1,,2532 ORCHARD,1509000,1345000,276000,1621000
2023,District of Oak Bay,08-2808-00,V8Z 0B4,,2546 ORCHARD,1513000,1345000,293000,1638000
2023,District of Oak Bay,08-2808-00,T3B 5C8,,2546 ORCHARD,1513000,1345000,293000,1638000
2023,District of Oak Bay,08-2808-00,T3A 4X7,,2546 ORCHARD,1513000,1345000,293000,1638000
2023,District of Oak Bay,08-2809-00,V8S 3B1,,2560 ORCHARD,1704000,1344000,471000,1815000
2023,District of Oak Bay,08-2810-00,V8S 5E4,,1106 NEWPORT,2183000,1345000,1004000,2349000
2023,District of Oak Bay,08-2810-00,T6G 2B1,,1106 NEWPORT,2183000,1345000,1004000,2349000
2023,District of Oak Bay,08-2811-00,V8S 5E4,,1110 NEWPORT,2780000,1344200,1639700,2983900
2023,District of Oak Bay,08-2812-00,V8S 5E4,,1122 NEWPORT,1585000,1344000,365000,1709000
2023,District of Oak Bay,08-2813-00,V8S 5E4,,1130 NEWPORT,1517000,1344000,291000,1635000
2023,District of Oak Bay,08-2814-00,V8R 6M6,,3595 BEACH,4710000,3696000,801000,4497000
2023,District of Oak Bay,08-2817-00,V8R 6M6,,3515 BEACH,4090000,3587000,246000,3833000
2023,District of Oak Bay,08-2820-00,V8R 5T7,,3425 BEACH,3997000,3450000,843000,4293000
2023,District of Oak Bay,08-2820-00,V8R 3P6,,3425 BEACH,3997000,3450000,843000,4293000
2023,District of Oak Bay,08-2823-00,V8R 5K9,,3615 CADBORO BAY,3068000,2620000,775000,3395000
2023,District of Oak Bay,08-2824-00,V8R 5K9,,3611 CADBORO BAY,2296200,2455000,32500,2487500
2023,District of Oak Bay,08-2825-00,V8R 6M7,,3572 BEACH,2132400,2267000,26700,2293700
2023,District of Oak Bay,08-2826-00,V8R 6M7,,3570 BEACH,3668000,2549000,1523000,4072000
2023,District of Oak Bay,08-2827-00,V8R 6E8,,3525 UPPER TERRACE,3933000,3108000,1241000,4349000
2023,District of Oak Bay,08-2828-00,V8R 6G2,,3530 MIDLAND,3047000,2605000,817000,3422000
2023,District of Oak Bay,08-2829-00,V8R 6E8,,3515 UPPER TERRACE,4072000,3539000,817000,4356000
2023,District of Oak Bay,08-2830-00,L5H 3L4,,3505 UPPER TERRACE,2900000,3080000,375000,3455000
2023,District of Oak Bay,08-2830-00,V8Y 3K3,,3505 UPPER TERRACE,2900000,3080000,375000,3455000
2023,District of Oak Bay,08-2831-00,V8R 6E8,,3495 UPPER TERRACE,2998000,2528000,827000,3355000
2023,District of Oak Bay,08-2832-00,V8R 6E8,,3485 UPPER TERRACE,3480000,3002000,741000,3743000
2023,District of Oak Bay,08-2835-00,V8R 5K7,,3495 CADBORO BAY,1967000,2054000,53400,2107400
2023,District of Oak Bay,08-2836-00,V8R 5K7,,3475 CADBORO BAY,2306000,2403000,94700,2497700
2023,District of Oak Bay,08-2846-00,V4L 2M4,,3448 BEACH,3995000,3972000,305000,4277000
2023,District of Oak Bay,08-2847-00,V8R 6M5,,3420 BEACH,4489000,4040000,966000,5006000
2023,District of Oak Bay,08-2853-00,V8R 3T1,,3160 HUMBER,17875000,12217000,4611000,16828000
2023,District of Oak Bay,08-2854-00,V8R 3S9,,3195 HUMBER,12040000,10455000,645000,11100000
2023,District of Oak Bay,08-2857-01,V8R 6L7,,3175 BEACH,1686518,7018,1741500,1748518
2023,District of Oak Bay,08-2857-02,V8R 6L7,,3175 BEACH,9400,2000,7000,9000
2023,District of Oak Bay,08-2857-02,V9T 6J9,,3175 BEACH,9400,2000,7000,9000
2023,District of Oak Bay,08-2858-00,V8R 6T4,,3155 BEACH,13802000,7457000,5208000,12665000
2023,District of Oak Bay,08-2858-00,V8R 6T4,,3155 BEACH,13802000,7457000,5208000,12665000
2023,District of Oak Bay,08-2858-00,V8R 6T4,,3155 BEACH,13802000,7457000,5208000,12665000
2023,District of Oak Bay,08-2859-00,V8R 1G1,,3125 BEACH,9348000,8207000,1533000,9740000
2023,District of Oak Bay,08-2859-01,V9T 6J9,,3125 BEACH,8900,2000,6600,8600
2023,District of Oak Bay,08-2859-01,V8R 1G1,,3125 BEACH,8900,2000,6600,8600
2023,District of Oak Bay,08-2860-00,V8R 1G1,,3115 BEACH,3060000,3332000,1207000,4539000
2023,District of Oak Bay,08-2861-00,V8R 0A7,,3150 RUTLAND,13669000,10936000,1889000,12825000
2023,District of Oak Bay,08-2861-00,V8R 0A7,,3150 RUTLAND,13669000,10936000,1889000,12825000
2023,District of Oak Bay,08-2861-01,V8R 0A7,,3150 RUTLAND,20700,2000,17700,19700
2023,District of Oak Bay,08-2861-01,V9T 6J9,,3150 RUTLAND,20700,2000,17700,19700
2023,District of Oak Bay,08-2862-10,V8R 3R6,,2970 RUTLAND,6242000,5706000,1235000,6941000
2023,District of Oak Bay,08-2863-00,V8R 3R3,,3005 LANSDOWNE,2941000,2648000,481000,3129000
2023,District of Oak Bay,08-2866-00,V6J 2E1,,3000 RUTLAND,4476000,2536000,2113000,4649000
2023,District of Oak Bay,08-2868-00,V8R 1G1,,3170 RIPON,3247000,2868000,541000,3409000
2023,District of Oak Bay,08-2869-00,,,3160 RIPON,4623000,2684000,2600000,5284000
2023,District of Oak Bay,08-2870-00,V8R 6G5,,3150 RIPON,2667000,2516000,324000,2840000
2023,District of Oak Bay,08-2871-00,V8R 6G5,,3140 RIPON,2571000,2497000,262000,2759000
2023,District of Oak Bay,08-2872-00,V8R 6G5,,3120 RIPON,3008000,2455000,754000,3209000
2023,District of Oak Bay,08-2873-00,V8R 3P7,,2760 LANSDOWNE,2752000,2642000,312000,2954000
2023,District of Oak Bay,08-2874-00,V8R 6G1,,3125 MIDLAND,2579000,2260000,495000,2755000
2023,District of Oak Bay,08-2875-00,V8R 6G1,,3135 MIDLAND,2512000,2260000,407000,2667000
2023,District of Oak Bay,08-2876-00,V8R 6G1,,3145 MIDLAND,2432000,2260000,352000,2612000
2023,District of Oak Bay,08-2877-00,T6G 2B6,,3155 MIDLAND,3424000,2260000,1467000,3727000
2023,District of Oak Bay,08-2878-00,V8R 6G1,,3165 MIDLAND,3638000,2259000,2893000,5152000
2023,District of Oak Bay,08-2878-00,V8R 6G1,,3165 MIDLAND,3638000,2259000,2893000,5152000
2023,District of Oak Bay,08-2880-00,V8R 6E2,,3185 WEALD,3314000,2746000,811000,3557000
2023,District of Oak Bay,08-2881-00,V8R 6E2,,3165 WEALD,2461300,2626000,31100,2657100
2023,District of Oak Bay,08-2882-00,V8R 6E2,,3145 WEALD,3146000,2578000,786000,3364000
2023,District of Oak Bay,08-2884-00,V8R 6E2,,3125 WEALD,2937000,2550000,750000,3300000
2023,District of Oak Bay,08-2885-00,V8R 6E9,,3110 MIDLAND,3829000,2260000,2010000,4270000
2023,District of Oak Bay,08-2886-00,V8R 6E9,,3130 MIDLAND,2111300,2260000,25400,2285400
2023,District of Oak Bay,08-2887-00,V8R 6E9,,3140 MIDLAND,2415000,2260000,379000,2639000
2023,District of Oak Bay,08-2888-00,V8N 6L8,,3150 MIDLAND,2607000,2260000,518000,2778000
2023,District of Oak Bay,08-2889-00,V8R 6E9,,3160 MIDLAND,2113600,2258000,28300,2286300
2023,District of Oak Bay,08-2891-00,V8R 5K4,,3225 CADBORO BAY,2122800,2242000,62200,2304200
2023,District of Oak Bay,08-2892-00,V8R 5K4,,3245 CADBORO BAY,2261000,2242000,199000,2441000
2023,District of Oak Bay,08-2893-00,V8R 5K4,,3265 CADBORO BAY,2131300,2241000,46300,2287300
2023,District of Oak Bay,08-2894-00,V8R 5K4,,3285 CADBORO BAY,2121200,2242000,46500,2288500
2023,District of Oak Bay,08-2895-00,V8R 5K4,,3315 CADBORO BAY,3105000,2110000,1394000,3504000
2023,District of Oak Bay,08-2903-00,V8R 3P1,,2470 LANSDOWNE,3153000,2558000,998000,3556000
2023,District of Oak Bay,08-2904-00,V8R 5K2,,3025 CADBORO BAY,1894000,1640000,466000,2106000
2023,District of Oak Bay,08-2905-00,V8R 5K2,,3055 CADBORO BAY,3272000,1664000,2041000,3705000
2023,District of Oak Bay,08-2906-00,V8R 5K2,,3075 CADBORO BAY,1668300,1750000,58800,1808800
2023,District of Oak Bay,08-2907-00,V8R 5K2,,3085 CADBORO BAY,1998000,1835000,303000,2138000
2023,District of Oak Bay,08-2908-00,V8R 6B4,,3050 UPLANDS,2461000,2167000,580000,2747000
2023,District of Oak Bay,08-2909-00,V8R 6B1,,3040 UPLANDS,2007000,1949000,204000,2153000
2023,District of Oak Bay,08-2910-00,V8R 3P2,,2545 LANSDOWNE,3894000,2343000,1861000,4204000
2023,District of Oak Bay,08-2911-00,,,2555 LANSDOWNE,4320000,2343000,2234000,4577000
2023,District of Oak Bay,08-2912-00,V8R 3P2,,2575 LANSDOWNE,2680000,2343000,666000,3009000
2023,District of Oak Bay,08-2913-00,V8R 6C5,,2554 NOTTINGHAM,2486000,2674000,32800,2706800
2023,District of Oak Bay,08-2914-00,V8R 6C5,,2544 NOTTINGHAM,4124000,2606000,1870000,4476000
2023,District of Oak Bay,08-2915-00,V8R 6C5,,2538 NOTTINGHAM,2382200,2564000,19700,2583700
2023,District of Oak Bay,08-2915-00,V8R 6K8,,2538 NOTTINGHAM,2382200,2564000,19700,2583700
2023,District of Oak Bay,08-2916-00,V8R 6C5,,2530 NOTTINGHAM,2404600,2577000,27800,2604800
2023,District of Oak Bay,08-2917-00,V8R 6C5,,2510 NOTTINGHAM,4933000,3001000,2289000,5290000
2023,District of Oak Bay,08-2918-01,V8R 6B6,,3125 UPLANDS,3918000,2641000,1812000,4453000
2023,District of Oak Bay,08-2919-00,V8R 3P3,,2570 LANSDOWNE,2354400,2460000,73600,2533600
2023,District of Oak Bay,08-2920-00,T2L 0W6,,2550 LANSDOWNE,2496000,2363000,403000,2766000
2023,District of Oak Bay,08-2925-00,V8R 3P4,,2625 LANSDOWNE,2922000,2347000,941000,3288000
2023,District of Oak Bay,08-2930-00,V8R 3P6,,2765 LANSDOWNE,4787000,2738000,2492000,5230000
2023,District of Oak Bay,08-2931-00,V8R 3P8,,2815 LANSDOWNE,2678200,2853000,31500,2884500
2023,District of Oak Bay,08-2932-00,V8R 3P8,,2835 LANSDOWNE,2098900,2201000,50000,2251000
2023,District of Oak Bay,08-2933-00,V8R 3M7,,2560 DORSET,2297700,2440000,33300,2473300
2023,District of Oak Bay,08-2934-00,V8R 6K7,,2820 BEACH,3157000,2729000,632000,3361000
2023,District of Oak Bay,08-2935-00,V8R 6K7,,2840 BEACH,2842000,2715000,335000,3050000
2023,District of Oak Bay,08-2936-00,V8R 6K7,,2850 BEACH,2623000,2654000,168000,2822000
2023,District of Oak Bay,08-2977-00,V8R 6A8,,2725 LINCOLN,2406000,1978000,722000,2700000
2023,District of Oak Bay,08-2978-00,V8R 6A8,,2755 LINCOLN,3381000,1843000,1898000,3741000
2023,District of Oak Bay,08-2979-00,V8R 6A8,,2775 LINCOLN,1957000,1844000,308000,2152000
2023,District of Oak Bay,08-2980-00,V8R 6A8,,2795 LINCOLN,2031000,2003000,224000,2227000
2023,District of Oak Bay,08-2981-00,V8R 6A8,,2835 LINCOLN,3836000,2321000,2021000,4342000
2023,District of Oak Bay,08-2982-00,V8R 6K5,,2780 BEACH,2328000,2302000,200000,2502000
2023,District of Oak Bay,08-2983-00,V8R 6K5,,2760 BEACH,2339000,2187000,304000,2491000
2023,District of Oak Bay,08-2984-00,V8R 6K5,,2740 BEACH,2443000,2016000,2363000,4379000
2023,District of Oak Bay,08-2985-00,V8R 6K5,,2720 BEACH,2082000,1910000,315000,2225000
2023,District of Oak Bay,08-2986-00,V8R 6K5,,2700 BEACH,2132000,1957000,320000,2277000
2023,District of Oak Bay,08-2987-00,V8R 1G2,, BEACH,195000,229000,0,229000
2023,District of Oak Bay,08-2988-00,V8R 1G2,, BEACH,371000,427000,0,427000
2023,District of Oak Bay,08-2990-00,V8R 1G2,, UPPER TERRACE,144000,166000,0,166000
2023,District of Oak Bay,08-2991-00,V8R 1G2,, MIDLAND,269000,309000,0,309000
2023,District of Oak Bay,08-2992-00,V8R 1G2,, UPPER TERRACE,95900,111000,0,111000
2023,District of Oak Bay,08-2993-00,V8R 1G2,, UPLANDS,142000,164000,0,164000
2023,District of Oak Bay,08-2994-00,V8R 1G2,, NOTTINGHAM,1702000,1968000,0,1968000
2023,District of Oak Bay,08-2996-00,V8R 1G2,, ESPLANADE,714000,828000,0,828000
2023,District of Oak Bay,08-2997-00,V8R 1G2,, BEACH,877000,1023000,0,1023000
2023,District of Oak Bay,08-2998-00,V8R 1G2,, BEACH,729000,842000,0,842000
2023,District of Oak Bay,08-2999-00,V8R 1G2,, BEACH,825000,951000,0,951000
2023,District of Oak Bay,08-3000-00,V8R 1G2,, RUTLAND,107000,125000,0,125000
2023,District of Oak Bay,08-3001-00,V8R 1G2,, LANSDOWNE,14100,16200,0,16200
2023,District of Oak Bay,08-3003-00,V8S 2G1,,2297 BRIGHTON,1610000,1402000,324000,1726000
2023,District of Oak Bay,08-3004-00,V8S 2G1,,2275 BRIGHTON,1436000,1402000,138000,1540000
2023,District of Oak Bay,08-3005-00,V8S 4V7,,1285 MONTEREY,1615000,1363000,392000,1755000
2023,District of Oak Bay,08-3006-01,V8S 4V7,,1271 MONTEREY,2741000,1363000,1703000,3066000
2023,District of Oak Bay,08-3006-02,V8S 4V7,,1261 MONTEREY,2380000,1302000,1371000,2673000
2023,District of Oak Bay,08-3007-00,V8S 4V7,,1241 MONTEREY,1480000,1302000,319000,1621000
2023,District of Oak Bay,08-3008-00,V8S 4V7,,1233 MONTEREY,1425000,1302000,239000,1541000
2023,District of Oak Bay,08-3009-00,V8S 4W9,,1230 OLIVER,1608000,1340000,382000,1722000
2023,District of Oak Bay,08-3010-00,V8S 4W9,,1242 OLIVER,2528000,1340000,1497000,2837000
2023,District of Oak Bay,08-3011-00,V8S 4W9,,1256 OLIVER,1466000,1340000,246000,1586000
2023,District of Oak Bay,08-3012-00,V8R 1R2,,2011 MEADOW,856800,856000,79900,935900
2023,District of Oak Bay,08-3013-00,V8R 5A5,,1733 FOUL BAY,857000,856000,79500,935500
2023,District of Oak Bay,08-3014-00,V8R 1R2,,2017 MEADOW,966000,994000,65000,1059000
2023,District of Oak Bay,08-3015-00,V8R 1R2,,2023 MEADOW,978300,994000,74700,1068700
2023,District of Oak Bay,08-3016-00,V8R 1R2,,2029 MEADOW,1856000,994000,1083000,2077000
2023,District of Oak Bay,08-3017-00,V8R 1R2,,2035 MEADOW,988600,994000,86800,1080800
2023,District of Oak Bay,08-3018-00,V8R 1R2,,2041 MEADOW,1036000,994000,133000,1127000
2023,District of Oak Bay,08-3019-00,V8R 1R2,,2047 MEADOW,1474000,994000,623000,1617000
2023,District of Oak Bay,08-3020-00,V8R 1R2,,2053 MEADOW,1640000,994000,821000,1815000
2023,District of Oak Bay,08-3021-00,V8R 1R3,,2054 MEADOW,924400,974000,31600,1005600
2023,District of Oak Bay,08-3022-00,V8R 1R3,,2048 MEADOW,1464000,974000,634000,1608000
2023,District of Oak Bay,08-3023-00,V8R 1R3,,2042 MEADOW,1071000,974000,197000,1171000
2023,District of Oak Bay,08-3024-00,V8R 1R3,,2036 MEADOW,935300,974000,46600,1020600
2023,District of Oak Bay,08-3025-00,V8R 1R3,,2030 MEADOW,995400,974000,107000,1081000
2023,District of Oak Bay,08-3026-00,V8R 1R3,,2024 MEADOW,1028000,970000,143000,1113000
2023,District of Oak Bay,08-3027-00,V8R 1R3,,2018 MEADOW,1149000,978000,275000,1253000
2023,District of Oak Bay,08-3028-00,V8R 5A6,,1895 FOUL BAY,1605000,841000,908000,1749000
2023,District of Oak Bay,08-3029-00,V8R 1H7,,1893 FOUL BAY,809900,838000,46700,884700
2023,District of Oak Bay,08-3030-00,V8S 2L5,,120 BEACH,1447000,1560000,185000,1745000
2023,District of Oak Bay,08-3031-00,V8S 2L5,,114 BEACH,1377000,1411000,243000,1654000
2023,District of Oak Bay,08-3032-00,V8S 2L5,,110 BEACH,1413000,1364000,320000,1684000
2023,District of Oak Bay,08-3033-00,V8S 4M6,,524 VICTORIA,1321000,1168000,251000,1419000
2023,District of Oak Bay,08-3034-00,V8S 2P3,,2130 HALL,1376000,1199000,277000,1476000
2023,District of Oak Bay,08-3035-00,V8S 4M6,,516 VICTORIA,1864000,1537000,478000,2015000
2023,District of Oak Bay,08-3036-00,V8S 4M6,,506 VICTORIA,1407000,1350000,155000,1505000
2023,District of Oak Bay,08-3037-00,V8S 4M6,,494 VICTORIA,2603000,1506000,1437000,2943000
2023,District of Oak Bay,08-3038-00,V8S 4M6,,480 VICTORIA,1490000,1344000,263000,1607000
2023,District of Oak Bay,08-3039-00,V8S 4M6,,466 VICTORIA,1173400,1216000,45700,1261700
2023,District of Oak Bay,08-3042-01,V8S 2J8,,19 KING GEORGE,2233000,1806000,821000,2627000
2023,District of Oak Bay,08-3042-02,V8P 1G5,,23 KING GEORGE,1170000,1405000,407000,1812000
2023,District of Oak Bay,08-3043-00,V8S 2H8,,2034 LORNE,1730000,1523000,359000,1882000
2023,District of Oak Bay,08-3046-00,V8S 2J9,,93 KING GEORGE,2380000,2596000,281000,2877000
2023,District of Oak Bay,08-3046-01,V8S 2H8,,2064 LORNE,1465700,1472000,103000,1575000
2023,District of Oak Bay,08-3050-00,V8S 2H8,,2090 LORNE,2242000,1567000,887000,2454000
2023,District of Oak Bay,08-3050-01,V8S 2J8,,125 KING GEORGE,3215000,2213000,1617000,3830000
2023,District of Oak Bay,08-3051-00,V8S 2H8,,2104 LORNE,2710000,1831000,1173000,3004000
2023,District of Oak Bay,08-3052-00,V8R 1G2,, KING GEORGE,1139000,1313000,0,1313000
2023,District of Oak Bay,08-3053-00,V8R 1G2,, KING GEORGE,1139000,1313000,0,1313000
2023,District of Oak Bay,08-3054-00,V4R 1P5,,2116 LORNE,1828000,1776000,202000,1978000
2023,District of Oak Bay,08-3054-00,V4V 1L8,,2116 LORNE,1828000,1776000,202000,1978000
2023,District of Oak Bay,08-3055-00,V8R 1G2,, KING GEORGE,1139000,1313000,0,1313000
2023,District of Oak Bay,08-3058-01,V8S 2J4,,48 MAQUINNA,2341000,1292000,1363000,2655000
2023,District of Oak Bay,08-3058-02,V8S 2J4,,52 MAQUINNA,2202000,1240000,1263000,2503000
2023,District of Oak Bay,08-3061-00,V8P 4P8,,2135 LORNE,981100,1003000,49900,1052900
2023,District of Oak Bay,08-3062-00,V8S 2H9,,2129 LORNE,1754000,1565000,338000,1903000
2023,District of Oak Bay,08-3063-00,V8S 2H9,,2125 LORNE,1353000,1333000,120000,1453000
2023,District of Oak Bay,08-3064-00,V8S 2H6,,2124 QUIMPER,1607000,1333000,413000,1746000
2023,District of Oak Bay,08-3065-00,V8S 2H6,,2114 QUIMPER,1269900,1334000,37800,1371800
2023,District of Oak Bay,08-3066-00,V8S 2H9,,2115 LORNE,1286200,1333000,47800,1380800
2023,District of Oak Bay,08-3068-00,V8S 2H9,,2095 LORNE,1442000,1334000,335000,1669000
2023,District of Oak Bay,08-3069-00,V8S 2H6,,2094 QUIMPER,1643000,1490000,283000,1773000
2023,District of Oak Bay,08-3069-00,V8S 2H6,,2094 QUIMPER,1643000,1490000,283000,1773000
2023,District of Oak Bay,08-3070-00,V8S 2H6,,2084 QUIMPER,1194000,1143000,157000,1300000
2023,District of Oak Bay,08-3071-00,V8S 2H9,,2085 LORNE,1378000,1334000,144000,1478000
2023,District of Oak Bay,08-3072-00,V8P 4R7,,2075 LORNE,1365000,1334000,130000,1464000
2023,District of Oak Bay,08-3073-00,V8Y 3J8,,2078 QUIMPER,1374000,1335000,139000,1474000
2023,District of Oak Bay,08-3074-00,V8S 2H6,,2074 QUIMPER,2121000,1402000,963000,2365000
2023,District of Oak Bay,08-3075-00,V8S 2H6,,2064 QUIMPER,1443000,1352000,199000,1551000
2023,District of Oak Bay,08-3076-00,V8S 2H7,,2079 QUIMPER,2328000,1203000,1423000,2626000
2023,District of Oak Bay,08-3077-00,V8R 1G2,, CRESCENT,420000,481000,0,481000
2023,District of Oak Bay,08-3078-00,V8S 2H7,,2087 QUIMPER,1728000,1544000,314000,1858000
2023,District of Oak Bay,08-3079-00,V8S 2H7,,2097 QUIMPER,1647000,1544000,213000,1757000
2023,District of Oak Bay,08-3080-00,V8R 1G2,, QUIMPER,724000,844000,0,844000
2023,District of Oak Bay,08-3081-00,V8R 1G2,,2115 QUIMPER,767600,844000,49700,893700
2023,District of Oak Bay,08-3082-00,V8R 1G2,, QUIMPER,724000,844000,0,844000
2023,District of Oak Bay,08-3083-00,V8S 2H7,,2125 QUIMPER,1353400,1403000,57200,1460200
2023,District of Oak Bay,08-3084-00,V8S 2H7,,2147 QUIMPER,1433000,1404000,129000,1533000
2023,District of Oak Bay,08-3085-00,V8S 2H7,,2153 QUIMPER,1597000,1404000,328000,1732000
2023,District of Oak Bay,08-3087-00,V8M 1S1,,2048 PENZANCE,1466400,1509000,68400,1577400
2023,District of Oak Bay,08-3088-00,V8S 2H5,,2032 PENZANCE,1907000,1507000,568000,2075000
2023,District of Oak Bay,08-3089-00,V8S 2H5,,2026 PENZANCE,2241000,2069000,341000,2410000
2023,District of Oak Bay,08-3090-00,V8S 2H5,,2024 PENZANCE,1809400,1852000,88200,1940200
2023,District of Oak Bay,08-3091-00,V8S 2H5,,2020 PENZANCE,1915000,1824000,227000,2051000
2023,District of Oak Bay,08-3092-00,V8S 2H3,,2130 CRESCENT,1792000,1755000,166000,1921000
2023,District of Oak Bay,08-3093-00,V7H 1V9,,2114 CRESCENT,1413000,1394000,122000,1516000
2023,District of Oak Bay,08-3094-00,V8S 2H5,,2120 PENZANCE,3965000,2978000,856000,3834000
2023,District of Oak Bay,08-3095-00,V8R 1G2,, HAMPSHIRE,44400,51100,0,51100
2023,District of Oak Bay,08-3096-00,V8R 5T7,,1687 HAMPSHIRE,1250000,1140000,222000,1362000
2023,District of Oak Bay,08-3097-00,V8R 1G2,, BOWKER,115000,133000,0,133000
2023,District of Oak Bay,08-3098-00,V8S 4P2,,1270 VICTORIA,1363000,1341000,134000,1475000
2023,District of Oak Bay,08-3099-00,V8S 4P2,,1260 VICTORIA,1422000,1337000,181000,1518000
2023,District of Oak Bay,08-3100-00,V8S 4P2,,1250 VICTORIA,1620000,1337000,430000,1767000
2023,District of Oak Bay,08-3101-00,V8S 4P2,,1240 VICTORIA,1552000,1337000,347000,1684000
2023,District of Oak Bay,08-3102-00,V8S 4P2,,1230 VICTORIA,1578000,1337000,359000,1696000
2023,District of Oak Bay,08-3103-00,V8S 4P2,,1218 VICTORIA,2401000,1334000,1357000,2691000
2023,District of Oak Bay,08-3104-00,V8S 4P2,,1198 VICTORIA,1889000,1336000,692000,2028000
2023,District of Oak Bay,08-3105-00,V8S 4P2,,1186 VICTORIA,1436000,1335000,209000,1544000
2023,District of Oak Bay,08-3106-00,V8S 4P2,,1174 VICTORIA,1386000,1335000,155000,1490000
2023,District of Oak Bay,08-3107-00,V8S 4P6,,1173 HEWLETT,1344000,1319000,123000,1442000
2023,District of Oak Bay,08-3108-00,V8S 4P6,,1187 HEWLETT,1598000,1323000,400000,1723000
2023,District of Oak Bay,08-3111-00,V8S 4P6,,1231 HEWLETT,1289000,1217000,173000,1390000
2023,District of Oak Bay,08-3111-00,V8S 4P6,,1231 HEWLETT,1289000,1217000,173000,1390000
2023,District of Oak Bay,08-3113-00,V8S 4P6,,1245 HEWLETT,1582000,1522000,202000,1724000
2023,District of Oak Bay,08-3113-00,V8S 4P6,,1245 HEWLETT,1582000,1522000,202000,1724000
2023,District of Oak Bay,08-3114-00,V8S 4P6,,1259 HEWLETT,1509000,1323000,298000,1621000
2023,District of Oak Bay,08-3115-00,V6R 3C6,,1273 HEWLETT,1305000,1290000,112000,1402000
2023,District of Oak Bay,08-3116-00,V8S 4P6,,1279 HEWLETT,1392000,1317000,182000,1499000
2023,District of Oak Bay,08-3117-00,V8S 4P7,,1280 HEWLETT,1303000,1232000,161000,1393000
2023,District of Oak Bay,08-3118-00,V8S 4P7,,1274 HEWLETT,1284900,1287000,108000,1395000
2023,District of Oak Bay,08-3119-00,V8S 4P7,,1260 HEWLETT,1423000,1288000,284000,1572000
2023,District of Oak Bay,08-3121-00,V8S 4P7,,1234 HEWLETT,2423000,1715000,963000,2678000
2023,District of Oak Bay,08-3122-00,V8S 4P7,,1218 HEWLETT,3407000,1718000,1978000,3696000
2023,District of Oak Bay,08-3123-00,V8S 4P7,,1190 HEWLETT,1754000,1719000,191000,1910000
2023,District of Oak Bay,08-3126-00,V8S 5B6,,1160 ST. LOUIS,1429000,1402000,125000,1527000
2023,District of Oak Bay,08-3127-00,V8S 5B6,,1120 ST. LOUIS,1577000,1382000,317000,1699000
2023,District of Oak Bay,08-3129-00,V8S 5B6,,1086 ST. LOUIS,2138000,1889000,411000,2300000
2023,District of Oak Bay,08-3129-00,V8S 5B6,,1086 ST. LOUIS,2138000,1889000,411000,2300000
2023,District of Oak Bay,08-3130-00,V8S 5B6,,1068 ST. LOUIS,1846000,1677000,303000,1980000
2023,District of Oak Bay,08-3131-00,V8S 5B6,,1050 ST. LOUIS,1623000,1432000,341000,1773000
2023,District of Oak Bay,08-3132-00,V8S 5B6,,1040 ST. LOUIS,1615000,1516000,214000,1730000
2023,District of Oak Bay,08-3136-00,V8S 2Z4,,2486 MCNEILL,1384000,1325000,166000,1491000
2023,District of Oak Bay,09-3138-00,V8S 3C2,,2097 WINDSOR,2695000,1493000,1566000,3059000
2023,District of Oak Bay,09-3139-00,V8S 3C2,,2083 WINDSOR,2520000,1615000,1198000,2813000
2023,District of Oak Bay,09-3140-00,V8S 4P2,,1160 VICTORIA,1546000,1352000,321000,1673000
2023,District of Oak Bay,09-3141-00,V8S 5B3,,1150 VICTORIA,1385000,1378000,107000,1485000
2023,District of Oak Bay,09-3141-00,V8S 4P2,,1150 VICTORIA,1385000,1378000,107000,1485000
2023,District of Oak Bay,09-3142-00,V8S 3C3,,2110 WINDSOR,1256400,1239000,107000,1346000
2023,District of Oak Bay,09-3142-00,V8S 3C3,,2110 WINDSOR,1256400,1239000,107000,1346000
2023,District of Oak Bay,09-3143-00,V8V 3K4,,1146 VICTORIA,1553000,1532000,146000,1678000
2023,District of Oak Bay,09-3143-00,V8V 3K4,,1146 VICTORIA,1553000,1532000,146000,1678000
2023,District of Oak Bay,09-3144-00,V8S 3C2,,2109 WINDSOR,1995000,1598000,570000,2168000
2023,District of Oak Bay,09-3145-05,V8S 3C2,,2105 WINDSOR,1387000,1211000,286000,1497000
2023,District of Oak Bay,09-3145-10,V8S 4P1,,1090 VICTORIA,1331000,1169000,270000,1439000
2023,District of Oak Bay,09-3146-00,V6J 2H5,,2106 SUTHERLAND,1361000,1208000,265000,1473000
2023,District of Oak Bay,09-3146-00,V6J 2H5,,2106 SUTHERLAND,1361000,1208000,265000,1473000
2023,District of Oak Bay,09-3147-00,V8S 3A1,,2112 SUTHERLAND,1250000,1208000,572000,1780000
2023,District of Oak Bay,09-3148-00,V8S 3A1,,2116 SUTHERLAND,1334000,1209000,203000,1412000
2023,District of Oak Bay,09-3149-00,V8S 3A1,,2120 SUTHERLAND,1415000,1220000,309000,1529000
2023,District of Oak Bay,09-3150-00,V8S 2Z9,,2109 SUTHERLAND,1335000,1316000,126000,1442000
2023,District of Oak Bay,09-3151-00,V8S 2Z9,,2101 SUTHERLAND,1290100,1322000,65500,1387500
2023,District of Oak Bay,09-3151-00,V8S 2Z9,,2101 SUTHERLAND,1290100,1322000,65500,1387500
2023,District of Oak Bay,09-3152-00,V8S 4M3,,1031 FALKLAND,1605000,1329000,410000,1739000
2023,District of Oak Bay,09-3153-00,V8S 4M3,,1023 FALKLAND,1415000,1335000,215000,1550000
2023,District of Oak Bay,09-3154-00,V8S 4M3,,1015 FALKLAND,1472000,1341000,228000,1569000
2023,District of Oak Bay,09-3155-00,V8S 4M3,,1009 FALKLAND,1375000,1280000,225000,1505000
2023,District of Oak Bay,09-3156-00,V8S 4N8,,1050 VICTORIA,1369000,1159000,318000,1477000
2023,District of Oak Bay,09-3157-00,V8S 2Z9,,2113 SUTHERLAND,1123500,1141000,69200,1210200
2023,District of Oak Bay,09-3158-01,V8E 0A8,,2111 SUTHERLAND,1697000,1086000,758000,1844000
2023,District of Oak Bay,09-3158-01,V8S 2Z9,,2111 SUTHERLAND,1697000,1086000,758000,1844000
2023,District of Oak Bay,09-3159-00,V8S 4N8,,1036 VICTORIA,1375000,1329000,147000,1476000
2023,District of Oak Bay,09-3160-00,V0R 2P2,,1028 VICTORIA,1550000,1335000,347000,1682000
2023,District of Oak Bay,09-3161-00,V8S 2Y2,,2122 MCNEILL,1245000,1067000,272000,1339000
2023,District of Oak Bay,09-3162-00,V8S 4N8,,1016 VICTORIA,1191000,1163000,126000,1289000
2023,District of Oak Bay,09-3163-00,V8S 2Y2,,2130 MCNEILL,1198000,1109000,177000,1286000
2023,District of Oak Bay,09-3164-00,V8R 2E5,,2363 BOWKER,1320000,1097000,331000,1428000
2023,District of Oak Bay,09-3165-00,V8R 2E5,,2373 BOWKER,1326000,1093000,340000,1433000
2023,District of Oak Bay,09-3166-00,V8R 5T8,,1958 HAMPSHIRE,1392000,1199000,313000,1512000
2023,District of Oak Bay,09-3167-01,V8R 5T8,,1936 HAMPSHIRE,2200000,1718000,687000,2405000
2023,District of Oak Bay,09-3168-00,V8R 5T8,,1910 HAMPSHIRE,1322000,1259000,188000,1447000
2023,District of Oak Bay,09-3169-00,V8R 5T8,,1900 HAMPSHIRE,1156000,1139000,119000,1258000
2023,District of Oak Bay,09-3170-00,V8R 5T8,,1894 HAMPSHIRE,1181000,1139000,173000,1312000
2023,District of Oak Bay,09-3171-00,V8R 5T8,,1882 HAMPSHIRE,1373000,1139000,352000,1491000
2023,District of Oak Bay,09-3172-00,V8R 5T8,,1868 HAMPSHIRE,1342000,1139000,330000,1469000
2023,District of Oak Bay,09-3173-00,V8R 5T8,,1852 HAMPSHIRE,1207000,1139000,174000,1313000
2023,District of Oak Bay,09-3174-00,V8R 5T8,,1838 HAMPSHIRE,1166000,1139000,129000,1268000
2023,District of Oak Bay,09-3175-00,V8R 1Z4,,2378 CRANMORE,1160000,1121000,144000,1265000
2023,District of Oak Bay,09-3176-00,V8R 1Z4,,2390 CRANMORE,1304000,1152000,278000,1430000
2023,District of Oak Bay,09-3177-00,V8R 1Z7,,2418 CRANMORE,1267000,1138000,250000,1388000
2023,District of Oak Bay,09-3178-00,V8R 1Z7,,2434 CRANMORE,1296000,1132000,323000,1455000
2023,District of Oak Bay,09-3179-00,V8R 1Z7,,2444 CRANMORE,1141000,1125000,113000,1238000
2023,District of Oak Bay,09-3180-00,V8R 5T9,,1839 HAMPSHIRE,1331000,1303000,137000,1440000
2023,District of Oak Bay,09-3181-01,V8R 5T9,,1845 HAMPSHIRE,1615000,1305000,478000,1783000
2023,District of Oak Bay,09-3181-02,V8R 5T9,,1853 HAMPSHIRE,1429000,1305000,255000,1560000
2023,District of Oak Bay,09-3182-00,V8R 5T9,,1881 HAMPSHIRE,1384000,1305000,209000,1514000
2023,District of Oak Bay,09-3183-00,V8R 5T9,,1903 HAMPSHIRE,1752000,1598000,307000,1905000
2023,District of Oak Bay,09-3184-00,V8R 6C5,,1917 HAMPSHIRE,1834000,1443000,551000,1994000
2023,District of Oak Bay,09-3185-00,V8R 5T9,,1931 HAMPSHIRE,1401000,1305000,213000,1518000
2023,District of Oak Bay,09-3186-00,V8R 5T9,,1957 HAMPSHIRE,1716000,1305000,584000,1889000
2023,District of Oak Bay,09-3187-00,V8R 5T9,,1959 HAMPSHIRE,1324000,1266000,173000,1439000
2023,District of Oak Bay,09-3188-00,V8R 5T9,,1989 HAMPSHIRE,1115000,1036000,181000,1217000
2023,District of Oak Bay,09-3189-00,V8R 2E7,,2431 BOWKER,1138000,1066000,173000,1239000
2023,District of Oak Bay,09-3190-00,V8R 2E7,,2447 BOWKER,1175000,1064000,210000,1274000
2023,District of Oak Bay,09-3191-00,V8S 4N5,,893 VICTORIA,2118000,1089000,1259000,2348000
2023,District of Oak Bay,09-3192-00,V8S 4N5,,901 VICTORIA,1124000,1089000,112000,1201000
2023,District of Oak Bay,09-3193-00,V8S 4N5,,913 VICTORIA,1207000,1089000,201000,1290000
2023,District of Oak Bay,09-3194-00,V8S 2W7,,2173 PENTLAND,1376000,1263000,218000,1481000
2023,District of Oak Bay,09-3195-00,V8S 2W7,,2175 PENTLAND,1302000,1273000,123000,1396000
2023,District of Oak Bay,09-3196-00,V8S 2W7,,2179 PENTLAND,1308000,1273000,130000,1403000
2023,District of Oak Bay,09-3197-00,V8S 2W7,,2187 PENTLAND,1415000,1273000,236000,1509000
2023,District of Oak Bay,09-3198-00,V8S 4S6,,920 HAMPSHIRE,1670000,1273000,584000,1857000
2023,District of Oak Bay,09-3198-00,V8S 4S6,,920 HAMPSHIRE,1670000,1273000,584000,1857000
2023,District of Oak Bay,09-3199-00,V8S 4S6,,902 HAMPSHIRE,1413000,1273000,256000,1529000
2023,District of Oak Bay,09-3199-00,V8S 4S6,,902 HAMPSHIRE,1413000,1273000,256000,1529000
2023,District of Oak Bay,09-3200-00,V8S 4S5,,868 HAMPSHIRE,1318000,1273000,142000,1415000
2023,District of Oak Bay,09-3200-00,V8S 4S5,,868 HAMPSHIRE,1318000,1273000,142000,1415000
2023,District of Oak Bay,09-3201-00,V8S 4S5,,836 HAMPSHIRE,1332000,1273000,152000,1425000
2023,District of Oak Bay,09-3202-00,V8S 2W3,,2191 SMYTHE,1366000,1273000,184000,1457000
2023,District of Oak Bay,09-3203-00,V8S 2W3,,2177 SMYTHE,1333000,1273000,161000,1434000
2023,District of Oak Bay,09-3204-00,V8S 2W3,,2171 SMYTHE,1380000,1273000,207000,1480000
2023,District of Oak Bay,09-3205-00,V8S 2W3,,2167 SMYTHE,1321000,1263000,20400,1283400
2023,District of Oak Bay,09-3206-00,V8S 4N4,,857 VICTORIA,1611000,1364000,356000,1720000
2023,District of Oak Bay,09-3207-00,V8S 4N4,,867 VICTORIA,1446000,1057000,810000,1867000
2023,District of Oak Bay,09-3208-00,V8S 4T5,,1395 HAMPSHIRE,2437000,1262000,1464000,2726000
2023,District of Oak Bay,09-3209-00,V8S 4T5,,1385 HAMPSHIRE,1342000,1303000,161000,1464000
2023,District of Oak Bay,09-3210-00,V8S 3G9,,2224 HAMPSHIRE,1577000,1451000,268000,1719000
2023,District of Oak Bay,09-3211-00,V8S 3G9,,2230 HAMPSHIRE,1114000,995000,229000,1224000
2023,District of Oak Bay,09-3211-00,V8S 3G9,,2230 HAMPSHIRE,1114000,995000,229000,1224000
2023,District of Oak Bay,09-3212-00,V8S 3G9,,2236 HAMPSHIRE,1034000,978000,150000,1128000
2023,District of Oak Bay,09-3213-00,V8S 4W1,,1400 MONTEREY,1398000,1177000,330000,1507000
2023,District of Oak Bay,09-3214-00,V8S 4W1,,1388 MONTEREY,1790000,1212000,676000,1888000
2023,District of Oak Bay,09-3215-00,V8S 4W1,,1376 MONTEREY,1261000,1212000,164000,1376000
2023,District of Oak Bay,09-3216-00,,,2201 OAK BAY,6294000,2699000,4171000,6870000
2023,District of Oak Bay,09-3216-00,V8R 6T2,,2201 OAK BAY,6294000,2699000,4171000,6870000
2023,District of Oak Bay,09-3216-00,V4T 1N1,,2201 OAK BAY,6294000,2699000,4171000,6870000
2023,District of Oak Bay,09-3216-00,V4T 1N1,,2201 OAK BAY,6294000,2699000,4171000,6870000
2023,District of Oak Bay,09-3216-00,V8R 6T2,,2201 OAK BAY,6294000,2699000,4171000,6870000
2023,District of Oak Bay,09-3216-00,,,2201 OAK BAY,6294000,2699000,4171000,6870000
2023,District of Oak Bay,09-3217-00,V8W 1R6,,1455 HAMPSHIRE,1443500,1425000,24900,1449900
2023,District of Oak Bay,09-3222-00,V8R 5W1,,1986 ST. ANN,1416000,1236000,319000,1555000
2023,District of Oak Bay,09-3223-00,V8R 5W1,,1972 ST. ANN,1458000,1235000,369000,1604000
2023,District of Oak Bay,09-3224-00,V8R 5W1,,1960 ST. ANN,1596000,1234000,522000,1756000
2023,District of Oak Bay,09-3225-00,V8R 5W1,,1946 ST. ANN,1550000,1234000,468000,1702000
2023,District of Oak Bay,09-3226-00,,,1932 ST. ANN,1525000,1233000,424000,1657000
2023,District of Oak Bay,09-3227-00,V8R 5W1,,1920 ST. ANN,1363000,1232000,250000,1482000
2023,District of Oak Bay,09-3228-00,V8R 5W1,,1906 ST. ANN,1538000,1232000,415000,1647000
2023,District of Oak Bay,09-3229-00,V8R 5W1,,1894 ST. ANN,1254000,1230000,131000,1361000
2023,District of Oak Bay,09-3230-00,V8R 5W1,,1880 ST. ANN,1487000,1230000,394000,1624000
2023,District of Oak Bay,09-3231-00,V8R 5W1,,1866 ST. ANN,1387000,1230000,325000,1555000
2023,District of Oak Bay,09-3232-00,V8R 5W1,,1854 ST. ANN,1441000,1229000,352000,1581000
2023,District of Oak Bay,09-3233-00,V8R 5W1,,1840 ST. ANN,1466000,1228000,374000,1602000
2023,District of Oak Bay,09-3234-00,V8R 5W1,,1828 ST. ANN,1422000,1230000,311000,1541000
2023,District of Oak Bay,09-3235-00,V8R 5W1,,1812 ST. ANN,1527000,1228000,450000,1678000
2023,District of Oak Bay,09-3236-00,V8S 4S3,,915 HAMPSHIRE,1752000,1205000,1331000,2536000
2023,District of Oak Bay,09-3236-00,V8S 4S3,,915 HAMPSHIRE,1752000,1205000,1331000,2536000
2023,District of Oak Bay,09-3237-00,V8S 4S3,,901 HAMPSHIRE,2198000,1205000,1221000,2426000
2023,District of Oak Bay,09-3238-00,V8S 4S3,,889 HAMPSHIRE,1287000,1205000,199000,1404000
2023,District of Oak Bay,09-3239-00,V8S 4S3,,875 HAMPSHIRE,1297000,1204000,185000,1389000
2023,District of Oak Bay,09-3240-00,V8S 4S3,,867 HAMPSHIRE,1285000,1205000,200000,1405000
2023,District of Oak Bay,09-3241-00,V8S 4S3,,855 HAMPSHIRE,1264000,1204000,145000,1349000
2023,District of Oak Bay,09-3242-00,V8S 4V2,,866 MONTEREY,1283000,1145000,219000,1364000
2023,District of Oak Bay,09-3243-00,V8S 4V2,,874 MONTEREY,1325000,1169000,251000,1420000
2023,District of Oak Bay,09-3244-00,V8S 2P7,,880 MONTEREY,1266000,1168000,220000,1388000
2023,District of Oak Bay,09-3245-00,V8S 4V2,,890 MONTEREY,1351000,1168000,278000,1446000
2023,District of Oak Bay,09-3246-00,V8S 4V2,,902 MONTEREY,1273000,1168000,224000,1392000
2023,District of Oak Bay,09-3247-00,,,916 MONTEREY,1428000,1169000,310000,1479000
2023,District of Oak Bay,09-3248-00,V8S 4Y7,,1053 ST. DAVID,1277600,1268000,104000,1372000
2023,District of Oak Bay,09-3249-00,V8S 4Y7,,1047 ST. DAVID,1256800,1269000,87800,1356800
2023,District of Oak Bay,09-3250-00,V8S 4Y7,,1039 ST. DAVID,1399000,1268000,232000,1500000
2023,District of Oak Bay,09-3251-00,V8S 4Y7,,1031 ST. DAVID,1334000,1268000,155000,1423000
2023,District of Oak Bay,09-3252-00,V8S 4Y7,,1023 ST. DAVID,1412000,1268000,246000,1514000
2023,District of Oak Bay,09-3253-00,V8S 4Y7,,1017 ST. DAVID,1305000,1269000,130000,1399000
2023,District of Oak Bay,09-3254-00,V8S 4Y7,,1009 ST. DAVID,1514000,1148000,521000,1669000
2023,District of Oak Bay,09-3255-00,V8S 5A2,,1064 TRANSIT,1627000,1207000,580000,1787000
2023,District of Oak Bay,09-3256-00,V8R 3E4,,1060 TRANSIT,1370000,1206000,248000,1454000
2023,District of Oak Bay,09-3257-00,V8S 5A2,,1048 TRANSIT,1196200,1206000,82900,1288900
2023,District of Oak Bay,09-3258-00,V8S 5A2,,1036 TRANSIT,1517000,1409000,216000,1625000
2023,District of Oak Bay,09-3259-00,V8S 5A2,,1024 TRANSIT,1447000,1397000,151000,1548000
2023,District of Oak Bay,09-3260-00,V8S 5A2,,1018 TRANSIT,1260000,1130000,232000,1362000
2023,District of Oak Bay,09-3260-05,V8S 5A2,,1010 TRANSIT,1108000,1008000,188000,1196000
2023,District of Oak Bay,09-3261-00,V8S 2M2,,308 BEACH,1869000,1881000,298000,2179000
2023,District of Oak Bay,09-3262-00,V5C 1R4,,320 BEACH,1610000,1740000,128000,1868000
2023,District of Oak Bay,09-3263-00,V8S 4T8,,437 MONTEREY,2585000,1566000,1329000,2895000
2023,District of Oak Bay,09-3264-00,V8S 4T8,,447 MONTEREY,1791000,1441000,491000,1932000
2023,District of Oak Bay,09-3265-00,V8S 4T8,,453 MONTEREY,1567000,1316000,367000,1683000
2023,District of Oak Bay,09-3266-00,V8S 4T8,,469 MONTEREY,2592000,1316000,1578000,2894000
2023,District of Oak Bay,09-3267-00,V8R 2A1,,2645 CRANMORE,1455000,1368000,208000,1576000
2023,District of Oak Bay,09-3268-00,V8R 2A1,,2657 CRANMORE,1608000,1597000,173000,1770000
2023,District of Oak Bay,09-3270-00,V8R 6J2,,1790 BEACH,2591000,2018000,825000,2843000
2023,District of Oak Bay,09-3276-00,V8S 3A3,,2555 MARGATE,1482000,1217000,385000,1602000
2023,District of Oak Bay,09-3277-00,V8S 3A3,,2559 MARGATE,1258000,1217000,133000,1350000
2023,District of Oak Bay,09-3278-00,V8S 3A3,,2565 MARGATE,1525000,1217000,443000,1660000
2023,District of Oak Bay,09-3279-00,V8S 3A3,,2575 MARGATE,1266000,1217000,140000,1357000
2023,District of Oak Bay,09-3280-00,V8S 5E1,,1006 NEWPORT,1912000,1600000,461000,2061000
2023,District of Oak Bay,09-3280-00,V8S 5E1,,1006 NEWPORT,1912000,1600000,461000,2061000
2023,District of Oak Bay,09-3284-00,V8R 5V9,,1955 ST. ANN,1318000,1156000,282000,1438000
2023,District of Oak Bay,09-3285-00,V8R 5V9,,1941 ST. ANN,1233000,1163000,178000,1341000
2023,District of Oak Bay,09-3286-00,V8R 5V9,,1927 ST. ANN,1211000,1171000,167000,1338000
2023,District of Oak Bay,09-3287-00,V8R 5V9,,1915 ST. ANN,1219000,1179000,146000,1325000
2023,District of Oak Bay,09-3288-00,V8R 5V9,,1899 ST. ANN,1212000,1187000,147000,1334000
2023,District of Oak Bay,09-3289-00,V8R 5V9,,1885 ST. ANN,1252000,1195000,195000,1390000
2023,District of Oak Bay,09-3290-00,V8R 5V9,,1875 ST. ANN,1311000,1202000,225000,1427000
2023,District of Oak Bay,09-3291-00,V8R 5V9,,1871 ST. ANN,1393000,1209000,318000,1527000
2023,District of Oak Bay,09-3292-00,V8R 5V9,,1841 ST. ANN,1326000,1217000,254000,1471000
2023,District of Oak Bay,09-3293-00,V8R 5V9,,1827 ST. ANN,1241000,1224000,141000,1365000
2023,District of Oak Bay,09-3294-00,V8R 5V9,,1815 ST. ANN,1394000,1231000,300000,1531000
2023,District of Oak Bay,09-3295-00,V8R 5W8,,1814 LULIE,1245000,1235000,140000,1375000
2023,District of Oak Bay,09-3296-00,V8R 5W8,,1828 LULIE,1310000,1235000,221000,1456000
2023,District of Oak Bay,09-3297-00,V8R 5W8,,1842 LULIE,1312000,1235000,201000,1436000
2023,District of Oak Bay,09-3298-00,V8R 5W8,,1856 LULIE,1283000,1235000,156000,1391000
2023,District of Oak Bay,09-3299-00,V8R 5W8,,1870 LULIE,1342000,1235000,259000,1494000
2023,District of Oak Bay,09-3300-00,V8R 5W8,,1884 LULIE,1419000,1235000,318000,1553000
2023,District of Oak Bay,09-3301-00,V8R 5W8,,1898 LULIE,1311000,1235000,203000,1438000
2023,District of Oak Bay,09-3302-00,V8R 5W8,,1914 LULIE,1250000,1235000,129000,1364000
2023,District of Oak Bay,09-3303-00,V8R 5W8,,1918 LULIE,1233600,1235000,106000,1341000
2023,District of Oak Bay,09-3304-00,V8R 5W8,,1930 LULIE,2353000,1234000,1445000,2679000
2023,District of Oak Bay,09-3305-00,V8R 5W8,,1956 LULIE,1286000,1235000,163000,1398000
2023,District of Oak Bay,09-3306-00,V8R 2E9,,2561 BOWKER,1307000,1246000,146000,1392000
2023,District of Oak Bay,09-3306-00,V8R 5N4,,2561 BOWKER,1307000,1246000,146000,1392000
2023,District of Oak Bay,09-3307-00,V8Z 1W2,,2569 BOWKER,1250000,1236000,126000,1362000
2023,District of Oak Bay,09-3308-00,V8R 5W9,,1953 LULIE,1304000,1219000,209000,1428000
2023,District of Oak Bay,09-3309-00,V8R 5W9,,1939 LULIE,1233000,1219000,138000,1357000
2023,District of Oak Bay,09-3310-00,V8R 5W9,,1925 LULIE,1201800,1219000,100000,1319000
2023,District of Oak Bay,09-3311-00,V8R 5W9,,1911 LULIE,1353000,1219000,254000,1473000
2023,District of Oak Bay,09-3312-00,V8R 5W9,,1897 LULIE,1219200,1220000,105000,1325000
2023,District of Oak Bay,09-3313-00,V8R 5W9,,1883 LULIE,1824000,1220000,831000,2051000
2023,District of Oak Bay,09-3314-00,V8R 5W9,,1869 LULIE,1416000,1220000,333000,1553000
2023,District of Oak Bay,09-3315-00,V8R 5W9,,1855 LULIE,1249000,1220000,137000,1357000
2023,District of Oak Bay,09-3316-00,V8R 5W9,,1841 LULIE,1486000,1220000,427000,1647000
2023,District of Oak Bay,09-3317-00,V8R 5W9,,1827 LULIE,1374000,1220000,290000,1510000
2023,District of Oak Bay,09-3318-00,V8R 5W9,,1813 LULIE,1280000,1220000,189000,1409000
2023,District of Oak Bay,09-3319-00,V8R 5X5,,1814 MONTEITH,1464000,1184000,431000,1615000
2023,District of Oak Bay,09-3320-00,V8R 5X5,,1828 MONTEITH,1291000,1184000,281000,1465000
2023,District of Oak Bay,09-3321-00,V8R 5X5,,1842 MONTEITH,1187300,1184000,122000,1306000
2023,District of Oak Bay,09-3322-00,V8R 5X5,,1856 MONTEITH,1290000,1184000,224000,1408000
2023,District of Oak Bay,09-3323-00,V8R 5X5,,1870 MONTEITH,1221000,1184000,166000,1350000
2023,District of Oak Bay,09-3324-00,V8R 5X5,,1884 MONTEITH,1202000,1184000,139000,1323000
2023,District of Oak Bay,09-3325-00,V0N 2M0,,1898 MONTEITH,1213000,1184000,152000,1336000
2023,District of Oak Bay,09-3326-00,V8R 5X5,,1912 MONTEITH,1145900,1184000,70300,1254300
2023,District of Oak Bay,09-3327-00,V8R 5X5,,1926 MONTEITH,1232000,1184000,175000,1359000
2023,District of Oak Bay,09-3328-00,V8R 5X5,,1940 MONTEITH,1200000,1184000,136000,1320000
2023,District of Oak Bay,09-3328-00,V8R 5T6,,1940 MONTEITH,1200000,1184000,136000,1320000
2023,District of Oak Bay,09-3329-10,V8R 5X5,,1954 MONTEITH,2506000,1184000,1605000,2789000
2023,District of Oak Bay,09-3330-00,V8R 2E9,,2579 BOWKER,1314000,1158000,315000,1473000
2023,District of Oak Bay,09-3331-00,V8R 2E9,,2589 BOWKER,1427000,1275000,296000,1571000
2023,District of Oak Bay,09-3332-00,V8R 5X6,,1939 MONTEITH,1235000,1211000,149000,1360000
2023,District of Oak Bay,09-3333-00,V8R 5X6,,1925 MONTEITH,1271000,1210000,195000,1405000
2023,District of Oak Bay,09-3334-00,V8R 5X6,,1909 MONTEITH,1322000,1210000,227000,1437000
2023,District of Oak Bay,09-3335-00,V8R 5X6,,1897 MONTEITH,1287000,1214000,210000,1424000
2023,District of Oak Bay,09-3336-00,V8R 5X6,,1883 MONTEITH,1321000,1210000,265000,1475000
2023,District of Oak Bay,09-3337-00,V8R 5X6,,1871 MONTEITH,1256000,1210000,180000,1390000
2023,District of Oak Bay,09-3338-00,V8R 5X6,,1859 MONTEITH,1485000,1210000,395000,1605000
2023,District of Oak Bay,09-3339-00,V8R 2C8,,2646 ANSCOMB,1787000,1715000,246000,1961000
2023,District of Oak Bay,09-3350-00,V8S 4Z4,,533 TRANSIT,1807000,1482000,623000,2105000
2023,District of Oak Bay,09-3351-00,V8S 4Z4,,519 TRANSIT,2820000,1622000,1794000,3416000
2023,District of Oak Bay,09-3352-00,V8S 4Z4,,513 TRANSIT,1811000,1743000,423000,2166000
2023,District of Oak Bay,09-3353-00,V8S 2M5,,468 BEACH,2077000,1892000,488000,2380000
2023,District of Oak Bay,09-3353-00,V8S 2M5,,468 BEACH,2077000,1892000,488000,2380000
2023,District of Oak Bay,09-3354-00,V8S 2M5,,472 BEACH,1964000,1770000,517000,2287000
2023,District of Oak Bay,09-3355-00,V8S 2M5,,480 BEACH,2498000,1791000,1144000,2935000
2023,District of Oak Bay,09-3356-00,V8S 2M5,,488 BEACH,1733000,1794000,208000,2002000
2023,District of Oak Bay,09-3357-00,V8S 2M5,,494 BEACH,2110000,1774000,667000,2441000
2023,District of Oak Bay,09-3359-00,V8R 1G2,, CALVERT,378000,442000,0,442000
2023,District of Oak Bay,09-3360-00,V8R 1G2,, CALVERT,340000,398000,0,398000
2023,District of Oak Bay,09-3361-00,V8R 1G2,, CALVERT,358000,419000,0,419000
2023,District of Oak Bay,09-3362-00,V8R 1G2,, CALVERT,311000,364000,0,364000
2023,District of Oak Bay,09-3366-00,V8S 4Z4,,521 TRANSIT,2267000,1347000,1394000,2741000
2023,District of Oak Bay,09-3367-00,V8S 4Z4,,525 TRANSIT,1995000,1233000,1103000,2336000
2023,District of Oak Bay,09-3373-00,V8R 2H5,,2399 DALHOUSIE,1579000,1396000,330000,1726000
2023,District of Oak Bay,09-3374-00,V8R 2H5,,2415 DALHOUSIE,1419000,1388000,162000,1550000
2023,District of Oak Bay,09-3375-00,V8R 2H5,,2423 DALHOUSIE,1418000,1391000,181000,1572000
2023,District of Oak Bay,09-3376-00,V8R 5X9,,2180 MUSGRAVE,1633000,1517000,252000,1769000
2023,District of Oak Bay,09-3377-00,V8R 5X9,,2156 MUSGRAVE,1505000,1438000,197000,1635000
2023,District of Oak Bay,09-3378-00,V8R 5H7,,2417 CADBORO BAY,1165000,1111000,164000,1275000
2023,District of Oak Bay,09-3379-00,T1W 2R7,,2338 DALHOUSIE,1541000,1551000,151000,1702000
2023,District of Oak Bay,09-3380-00,V8R 2H6,,2354 DALHOUSIE,1388000,1446000,1581000,3027000
2023,District of Oak Bay,09-3381-00,V8R 2H6,,2368 DALHOUSIE,2627000,1446000,1514000,2960000
2023,District of Oak Bay,09-3382-00,V8R 2H6,,2386 DALHOUSIE,1894000,1446000,635000,2081000
2023,District of Oak Bay,09-3383-00,V8R 2H6,,2400 DALHOUSIE,1789000,1446000,503000,1949000
2023,District of Oak Bay,09-3384-00,V8R 2H6,,2414 DALHOUSIE,1455000,1446000,141000,1587000
2023,District of Oak Bay,09-3385-00,V8R 2H6,,2428 DALHOUSIE,1543000,1446000,221000,1667000
2023,District of Oak Bay,09-3386-00,V8R 2H6,,2440 DALHOUSIE,1544000,1479000,211000,1690000
2023,District of Oak Bay,09-3387-00,V8Z 1E8,,2462 DALHOUSIE,787000,908000,0,908000
2023,District of Oak Bay,09-3388-00,V8Z 1E8,, DALHOUSIE,628000,735000,0,735000
2023,District of Oak Bay,09-3389-00,V8Z 1E8,, DALHOUSIE,650000,760000,0,760000
2023,District of Oak Bay,09-3390-00,V8S 2P7,,2107 MCLAREN,1672000,1150000,656000,1806000
2023,District of Oak Bay,09-3391-01,V8S 4L6,,595 FALKLAND,1362000,1143000,334000,1477000
2023,District of Oak Bay,09-3391-01,V8S 4L6,,595 FALKLAND,1362000,1143000,334000,1477000
2023,District of Oak Bay,09-3391-02,V8S 4L6,,585 FALKLAND,1397000,1143000,377000,1520000
2023,District of Oak Bay,09-3392-00,V8S 2P7,,2113 MCLAREN,1630000,1327000,446000,1773000
2023,District of Oak Bay,09-3393-00,V8S 2P7,,2119 MCLAREN,1369000,1327000,143000,1470000
2023,District of Oak Bay,09-3394-00,V8S 2P7,,2123 MCLAREN,1369000,1327000,142000,1469000
2023,District of Oak Bay,09-3395-00,V8S 2P7,,2131 MCLAREN,1683000,1548000,255000,1803000
2023,District of Oak Bay,09-3396-00,V8S 2P7,,2135 MCLAREN,2970000,1549000,1751000,3300000
2023,District of Oak Bay,09-3398-00,V8S 3G3,,2048 GRANITE,1214000,1110000,286000,1396000
2023,District of Oak Bay,09-3399-00,V8S 3G3,,2052 GRANITE,1165000,1110000,162000,1272000
2023,District of Oak Bay,09-3400-00,V8S 3G3,,2056 GRANITE,1175000,1110000,174000,1284000
2023,District of Oak Bay,09-3402-00,V8S 4R2,,1444 MITCHELL,1392000,1198000,306000,1504000
2023,District of Oak Bay,09-3404-00,V8R 5X1,,1523 YORK,1145700,1163000,98600,1261600
2023,District of Oak Bay,09-3405-00,V8R 1H2,,2364 OAK BAY,1231000,1079000,277000,1356000
2023,District of Oak Bay,09-3407-01,V8R 1H2,,2376 OAK BAY,1869000,1483000,595000,2078000
2023,District of Oak Bay,09-3408-00,V8R 1H2,,2390 OAK BAY,2286000,1881000,631000,2512000
2023,District of Oak Bay,09-3409-00,V8R 5X8,,1532 PROSPECT,2105000,2106000,196000,2302000
2023,District of Oak Bay,09-3410-00,V8R 5X1,, YORK,19500,21400,0,21400
2023,District of Oak Bay,09-3411-00,V8R 5X8,,1542 PROSPECT,1994000,1913000,275000,2188000
2023,District of Oak Bay,09-3412-00,V8R 5X1,, YORK,19500,21400,0,21400
2023,District of Oak Bay,09-3413-00,V8R 5X1,,1535 YORK,1807000,1785000,181000,1966000
2023,District of Oak Bay,09-3414-00,V8R 5X1,,1545 YORK,1769000,1784000,141000,1925000
2023,District of Oak Bay,09-3415-00,V8S 1Y1,,2159 GUERNSEY,1167900,1184000,70000,1254000
2023,District of Oak Bay,09-3416-00,V8S 2P5,,2163 GUERNSEY,1283000,1193000,182000,1375000
2023,District of Oak Bay,09-3417-00,V8S 2P5,,2167 GUERNSEY,1223000,1193000,115000,1308000
2023,District of Oak Bay,09-3418-00,V9B 1E1,,2175 GUERNSEY,1220000,1193000,113000,1306000
2023,District of Oak Bay,09-3419-00,V8S 2P5,,2179 GUERNSEY,1296000,1193000,178000,1371000
2023,District of Oak Bay,09-3420-00,V8S 2P5,,2183 GUERNSEY,1242000,1193000,142000,1335000
2023,District of Oak Bay,09-3421-00,V8P 4J8,,2187 GUERNSEY,1197500,1194000,89100,1283100
2023,District of Oak Bay,09-3422-00,V8S 2P5,,2195 GUERNSEY,1248000,1194000,142000,1336000
2023,District of Oak Bay,09-3423-00,V8S 4M8,,537 VICTORIA,1774000,1426000,504000,1930000
2023,District of Oak Bay,09-3424-00,V8S 4M8,,525 VICTORIA,1749000,1427000,474000,1901000
2023,District of Oak Bay,09-3425-00,V8S 4M8,,517 VICTORIA,957200,984000,38000,1022000
2023,District of Oak Bay,09-3426-00,V8R 4Z6,,511 VICTORIA,971800,1011000,35700,1046700
2023,District of Oak Bay,09-3427-00,V8S 4R8,,536 HAMPSHIRE,2135000,1718000,596000,2314000
2023,District of Oak Bay,09-3428-00,V8S 4R8,,518 HAMPSHIRE,2361000,1723000,848000,2571000
2023,District of Oak Bay,09-3429-00,V8S 5G7,,2737 SATELLITE,1436000,896000,697000,1593000
2023,District of Oak Bay,09-3430-00,V8P 2L5,,2747 SATELLITE,2541000,1413000,1382000,2795000
2023,District of Oak Bay,09-3431-00,V8S 2J8,,1203 BEACH,2447000,1644000,1047000,2691000
2023,District of Oak Bay,09-3432-00,V8S 2N2,,1193 BEACH,1551000,1152000,495000,1647000
2023,District of Oak Bay,09-3434-00,V8S 2H1,,1988 CRESCENT,1398000,1580000,109000,1689000
2023,District of Oak Bay,09-3434-01,V8R 1G2,, CRESCENT,48400,55700,0,55700
2023,District of Oak Bay,09-3435-00,V8S 2H1,,1984 CRESCENT,2569000,1643000,1467000,3110000
2023,District of Oak Bay,09-3436-00,V8S 2H1,,1978 CRESCENT,1502000,1645000,166000,1811000
2023,District of Oak Bay,09-3437-00,V8N 2X3,,1972 CRESCENT,1730000,1801000,285000,2086000
2023,District of Oak Bay,09-3438-00,V8S 2J5,,1966 CRESCENT,1863000,2019000,248000,2267000
2023,District of Oak Bay,09-3439-00,V8S 2H1,,1958 CRESCENT,2002000,2074000,322000,2396000
2023,District of Oak Bay,09-3440-00,V8S 2H1,,1946 CRESCENT,3394000,2072000,1810000,3882000
2023,District of Oak Bay,09-3441-00,V8R 2C7,,2647 ANSCOMB,1590000,1579000,160000,1739000
2023,District of Oak Bay,09-3441-00,V6B 1G3,,2647 ANSCOMB,1590000,1579000,160000,1739000
2023,District of Oak Bay,09-3442-00,V8R 2C7,,2645 ANSCOMB,1618000,1579000,183000,1762000
2023,District of Oak Bay,09-3443-10,V8S 2L3,,93 BEACH,1659000,1517000,471000,1988000
2023,District of Oak Bay,09-3443-20,V8S 2L3,,97 BEACH,2510000,1514000,1497000,3011000
2023,District of Oak Bay,09-3445-00,V8S 2L6,,105 BEACH,1387000,1330000,343000,1673000
2023,District of Oak Bay,09-3446-00,V6Z 2R1,,123 BEACH,1350000,1338000,295000,1633000
2023,District of Oak Bay,09-3447-00,V8S 2K8,,82 SYLVAN,1317000,1349000,224000,1573000
2023,District of Oak Bay,09-3448-00,V8S 2K8,,76 SYLVAN,1344000,1334000,315000,1649000
2023,District of Oak Bay,09-3449-00,V8S 2K8,,66 SYLVAN,1312000,1448000,148000,1596000
2023,District of Oak Bay,09-3450-00,V8S 2K8,,50 SYLVAN,2271000,2296000,430000,2726000
2023,District of Oak Bay,09-3450-00,V8S 2K8,,50 SYLVAN,2271000,2296000,430000,2726000
2023,District of Oak Bay,09-3451-00,V8S 2L3,,37 BEACH,2157000,2090000,463000,2553000
2023,District of Oak Bay,09-3453-00,V8S 4M1,,945 FALKLAND,1399000,1226000,290000,1516000
2023,District of Oak Bay,09-3454-00,V8S 4M1,,933 FALKLAND,1288000,1226000,184000,1410000
2023,District of Oak Bay,09-3455-00,V8S 2W4,,2112 PENTLAND,1319000,1227000,188000,1415000
2023,District of Oak Bay,09-3456-00,V8S 2W4,,2118 PENTLAND,1342800,1387000,62600,1449600
2023,District of Oak Bay,09-3457-00,V8S 2W4,,2124 PENTLAND,1427000,1386000,166000,1552000
2023,District of Oak Bay,09-3458-00,V8S 2W4,,2130 PENTLAND,1474000,1386000,214000,1600000
2023,District of Oak Bay,09-3459-00,V8S 2W4,,2136 PENTLAND,1366000,1387000,86500,1473500
2023,District of Oak Bay,09-3462-00,V8S 4L7,,649 FALKLAND,1487000,1387000,194000,1581000
2023,District of Oak Bay,09-3463-00,V8S 4L7,,627 FALKLAND,1601000,1387000,325000,1712000
2023,District of Oak Bay,09-3464-00,V8S 2P8,,2116 MCLAREN,2136000,1322000,1029000,2351000
2023,District of Oak Bay,09-3465-00,V8S 2P8,,2120 MCLAREN,1411000,1322000,191000,1513000
2023,District of Oak Bay,09-3466-00,V8S 2P8,,2124 MCLAREN,1293500,1322000,67400,1389400
2023,District of Oak Bay,09-3467-00,V8S 2P8,,2130 MCLAREN,1390000,1322000,169000,1491000
2023,District of Oak Bay,09-3468-00,V8S 2P8,,2136 MCLAREN,1560000,1322000,375000,1697000
2023,District of Oak Bay,09-3469-00,V8S 4N1,,650 VICTORIA,2200000,1187000,1240000,2427000
2023,District of Oak Bay,09-3470-00,V8S 4N1,,638 VICTORIA,2206000,1189000,1255000,2444000
2023,District of Oak Bay,09-3471-00,V8S 4N1,,626 VICTORIA,1182700,1189000,81700,1270700
2023,District of Oak Bay,09-3472-00,V8R 1B2,, DENISON,44200,53800,0,53800
2023,District of Oak Bay,09-3473-00,V8R 1B2,,394 DENISON,221000,270000,0,270000
2023,District of Oak Bay,09-3474-00,V8R 1B2,, GLEN,351000,427000,0,427000
2023,District of Oak Bay,09-3475-00,V8R 1B2,, GLEN,352000,429000,0,429000
2023,District of Oak Bay,09-3476-00,V8S 4K3,,308 DENISON,1452000,1430000,310000,1740000
2023,District of Oak Bay,09-3485-01,V8S 2J6,,134 BARKLEY,2983000,2106000,1477000,3583000
2023,District of Oak Bay,09-3486-00,V8S 2G5,,142 BARKLEY,2590000,2882000,253000,3135000
2023,District of Oak Bay,09-3487-00,V8S 4K3,, GLEN,72500,88200,0,88200
2023,District of Oak Bay,09-3488-00,V8S 2J6,,150 BARKLEY,2874000,2870000,528000,3398000
2023,District of Oak Bay,09-3489-00,V8S 4K3,,240 DENISON,2505000,2652000,361000,3013000
2023,District of Oak Bay,09-3489-00,V8S 4K3,,240 DENISON,2505000,2652000,361000,3013000
2023,District of Oak Bay,09-3489-00,V8S 4K3,,240 DENISON,2505000,2652000,361000,3013000
2023,District of Oak Bay,09-3489-00,V8S 4K3,,240 DENISON,2505000,2652000,361000,3013000
2023,District of Oak Bay,09-3490-00,V8L 5H3,,230 DENISON,2093000,2240000,287000,2527000
2023,District of Oak Bay,09-3490-00,V8L 5H3,,230 DENISON,2093000,2240000,287000,2527000
2023,District of Oak Bay,09-3490-00,V8S 4K3,,230 DENISON,2093000,2240000,287000,2527000
2023,District of Oak Bay,09-3490-00,V8S 4K3,,230 DENISON,2093000,2240000,287000,2527000
2023,District of Oak Bay,09-3491-00,V8S 4K3,,220 DENISON,1925000,2040000,270000,2310000
2023,District of Oak Bay,09-3491-00,V8S 2V8,,220 DENISON,1925000,2040000,270000,2310000
2023,District of Oak Bay,09-3492-00,V8S 2J6,,158 BARKLEY,2541000,2628000,436000,3064000
2023,District of Oak Bay,09-3492-00,V8S 2J6,,158 BARKLEY,2541000,2628000,436000,3064000
2023,District of Oak Bay,09-3494-00,V8S 4K3,,210 DENISON,2057000,2175000,291000,2466000
2023,District of Oak Bay,09-3495-00,V8S 2J6,,168 BARKLEY,3960000,2495000,2066000,4561000
2023,District of Oak Bay,09-3503-00,V8S 2J7,,20 KING GEORGE,1603000,1628000,285000,1913000
2023,District of Oak Bay,09-3504-00,V8S 2J7,,30 KING GEORGE,1800000,1889000,298000,2187000
2023,District of Oak Bay,09-3504-00,N5A 7T1,,30 KING GEORGE,1800000,1889000,298000,2187000
2023,District of Oak Bay,09-3505-00,V8S 4M1,,957 FALKLAND,1680000,1529000,259000,1788000
2023,District of Oak Bay,09-3506-00,V8S 4M1,,973 FALKLAND,1400000,1323000,181000,1504000
2023,District of Oak Bay,09-3507-00,V8S 4M1,,987 FALKLAND,1594000,1256000,491000,1747000
2023,District of Oak Bay,09-3508-00,V8S 2Y1,,2117 MCNEILL,1484000,1218000,385000,1603000
2023,District of Oak Bay,09-3509-00,V8S 2Y1,,2123 MCNEILL,1473000,1422000,161000,1583000
2023,District of Oak Bay,09-3510-00,V8S 2W4,,2129 MCNEILL,1514000,1423000,197000,1620000
2023,District of Oak Bay,09-3511-00,V8S 2Y1,,2135 MCNEILL,1550000,1423000,235000,1658000
2023,District of Oak Bay,09-3512-00,V8S 4N7,,958 VICTORIA,1351000,1326000,143000,1469000
2023,District of Oak Bay,09-3513-00,V8S 4N7,,974 VICTORIA,1298300,1326000,65100,1391100
2023,District of Oak Bay,09-3514-00,T3C 3E6,,988 VICTORIA,1571000,1243000,429000,1672000
2023,District of Oak Bay,09-3519-00,V8R 5G4,,2077 CADBORO BAY,1721000,1032000,726000,1758000
2023,District of Oak Bay,09-3519-00,V8R 5G4,,2077 CADBORO BAY,1721000,1032000,726000,1758000
2023,District of Oak Bay,09-3554-00,V8S 2J1,,2205 LORNE,3305000,3009000,10000,3019000
2023,District of Oak Bay,09-3554-00,V8S 2J1,,2205 LORNE,3305000,3009000,10000,3019000
2023,District of Oak Bay,09-3554-00,V8S 2J1,,2205 LORNE,3305000,3009000,10000,3019000
2023,District of Oak Bay,09-3558-00,V8R 5S5,,1773 ARMSTRONG,1683000,1441000,400000,1841000
2023,District of Oak Bay,09-3559-00,V8R 5S5,,1757 ARMSTRONG,1450000,1442000,131000,1573000
2023,District of Oak Bay,09-3560-00,V8R 5S5,,1753 ARMSTRONG,1366000,1234000,248000,1482000
2023,District of Oak Bay,09-3561-00,V8R 5S5,,1743 ARMSTRONG,1358000,1234000,236000,1470000
2023,District of Oak Bay,09-3562-00,V8R 5S5,,1731 ARMSTRONG,1245000,1234000,119000,1353000
2023,District of Oak Bay,09-3563-00,V8R 1G2,, ARMSTRONG,353000,360000,0,360000
2023,District of Oak Bay,09-3564-00,V8Z 1E8,,2283 CRANMORE,585000,685000,0,685000
2023,District of Oak Bay,09-3565-00,V8R 1Z2,,2295 CRANMORE,1407000,1218000,322000,1540000
2023,District of Oak Bay,09-3566-00,V8R 5S6,,1780 ARMSTRONG,1459000,1191000,409000,1600000
2023,District of Oak Bay,09-3567-00,V8R 5S6,,1774 ARMSTRONG,1419000,1190000,366000,1556000
2023,District of Oak Bay,09-3568-00,V8R 5S6,,1766 ARMSTRONG,1272000,1189000,192000,1381000
2023,District of Oak Bay,09-3569-00,V8R 5S6,,1758 ARMSTRONG,1370000,1188000,319000,1507000
2023,District of Oak Bay,09-3570-00,V8R 5S6,,1752 ARMSTRONG,1366000,1187000,316000,1503000
2023,District of Oak Bay,09-3571-00,V8R 5S6,,1746 ARMSTRONG,1234000,1186000,184000,1370000
2023,District of Oak Bay,09-3572-00,V8R 5S6,,1732 ARMSTRONG,1237000,1185000,159000,1344000
2023,District of Oak Bay,09-3573-00,V8R 1G2,, ARMSTRONG,373000,360000,0,360000
2023,District of Oak Bay,10-3574-00,V8S 4L4,,525 FALKLAND,1412000,1297000,224000,1521000
2023,District of Oak Bay,10-3575-00,V8S 4L4,,515 FALKLAND,1537000,1311000,324000,1635000
2023,District of Oak Bay,10-3576-00,V8S 2P4,,2117 HALL,1387000,1313000,175000,1488000
2023,District of Oak Bay,10-3577-00,V8R 5T7,,1715 HAMPSHIRE,1492000,1449000,199000,1648000
2023,District of Oak Bay,10-3578-00,V8R 5T7,,1709 HAMPSHIRE,1927000,1448000,668000,2116000
2023,District of Oak Bay,10-3580-00,V8R 6L8,,713 ST. PATRICK,1067000,999000,91100,1090100
2023,District of Oak Bay,10-3581-00,V8S 4X6,,723 ST. PATRICK,1251000,1198000,140000,1338000
2023,District of Oak Bay,10-3582-00,V8S 4X6,,733 ST. PATRICK,1531000,1198000,484000,1682000
2023,District of Oak Bay,10-3583-00,V8S 4X6,,745 ST. PATRICK,1588000,1231000,501000,1732000
2023,District of Oak Bay,10-3584-00,V2G 1S2,,757 ST. PATRICK,1883000,1883000,147000,2030000
2023,District of Oak Bay,10-3585-00,V8S 2S4,,2360 CENTRAL,1747000,1710000,187000,1897000
2023,District of Oak Bay,10-3586-00,V8S 2S4,,2374 CENTRAL,1729000,1710000,147000,1857000
2023,District of Oak Bay,10-3587-01,V8S 2S4,,2376 CENTRAL,1670000,1464000,368000,1832000
2023,District of Oak Bay,10-3587-02,V8S 2S4,,2386 CENTRAL,2016000,1464000,759000,2223000
2023,District of Oak Bay,10-3588-00,V8P 4Z7,,712 TRANSIT,1249000,1198000,154000,1352000
2023,District of Oak Bay,10-3589-00,V8S 4Z6,,724 TRANSIT,1215400,1199000,108000,1307000
2023,District of Oak Bay,10-3590-00,V5Y 0E3,,736 TRANSIT,1314000,1199000,218000,1417000
2023,District of Oak Bay,10-3591-00,V8S 4Z6,,748 TRANSIT,1369000,1231000,248000,1479000
2023,District of Oak Bay,10-3592-00,V8S 4Z7,,787 TRANSIT,2975000,1419000,1917000,3336000
2023,District of Oak Bay,10-3593-00,V8S 4Z7,,767 TRANSIT,1943000,1735000,364000,2099000
2023,District of Oak Bay,10-3594-00,V8S 4Z7,,757 TRANSIT,2184000,1734000,603000,2337000
2023,District of Oak Bay,10-3595-00,V8S 4Z7,,737 TRANSIT,1504000,1417000,187000,1604000
2023,District of Oak Bay,10-3596-00,V8R 6R5,,750 ISLAND,1817000,1589000,373000,1962000
2023,District of Oak Bay,10-3596-00,V8R 6R5,,750 ISLAND,1817000,1589000,373000,1962000
2023,District of Oak Bay,10-3599-00,V8S 2T9,,736 ISLAND,1893000,1589000,438000,2027000
2023,District of Oak Bay,10-3599-00,V8S 2T9,,736 ISLAND,1893000,1589000,438000,2027000
2023,District of Oak Bay,10-3600-00,V8S 2S6,,2406 CENTRAL,1233000,1186000,139000,1325000
2023,District of Oak Bay,10-3601-00,V8S 2S6,,2412 CENTRAL,1161300,1186000,67000,1253000
2023,District of Oak Bay,10-3602-00,V8S 2S6,,2418 CENTRAL,1311000,1187000,209000,1396000
2023,District of Oak Bay,10-3602-00,T1A 0B6,,2418 CENTRAL,1311000,1187000,209000,1396000
2023,District of Oak Bay,10-3603-00,V8S 2S6,,2424 CENTRAL,2275000,1187000,1374000,2561000
2023,District of Oak Bay,10-3604-00,V8S 2S6,,2430 CENTRAL,2071000,1187000,1095000,2282000
2023,District of Oak Bay,10-3605-00,V8S 2S6,,2436 CENTRAL,1280000,1188000,179000,1367000
2023,District of Oak Bay,10-3606-00,V8S 2T9,,722 ISLAND,1460000,1187000,370000,1557000
2023,District of Oak Bay,10-3607-00,V8R 6L8,,697 ST. PATRICK,1508000,990000,833000,1823000
2023,District of Oak Bay,10-3608-00,V8S 2L9,,677 ST. PATRICK,1461000,941000,726000,1667000
2023,District of Oak Bay,10-3609-00,T9H 3G5,,667 ST. PATRICK,1275000,1231000,135000,1366000
2023,District of Oak Bay,10-3610-00,V8S 4X4,,657 ST. PATRICK,1304000,1228000,168000,1396000
2023,District of Oak Bay,10-3611-00,V8S 4X4,,647 ST. PATRICK,1261000,1231000,119000,1350000
2023,District of Oak Bay,10-3612-00,V8S 4X4,,637 ST. PATRICK,1554000,1230000,453000,1683000
2023,District of Oak Bay,10-3613-00,V8S 2V2,,2361 CENTRAL,1716000,1488000,377000,1865000
2023,District of Oak Bay,10-3614-00,V8S 2M5,,2377 CENTRAL,1596000,1486000,252000,1738000
2023,District of Oak Bay,10-3615-00,V8S 2S5,,2389 CENTRAL,1528000,1509000,151000,1660000
2023,District of Oak Bay,10-3616-00,V8S 4Z5,,688 TRANSIT,1162400,1194000,57300,1251300
2023,District of Oak Bay,10-3616-01,V8S 4Z5,,678 TRANSIT,1877000,1230000,817000,2047000
2023,District of Oak Bay,10-3617-00,V0R 3B0,,668 TRANSIT,1276000,1242000,148000,1390000
2023,District of Oak Bay,10-3618-00,V8S 4Z5,,658 TRANSIT,1259000,1239000,121000,1360000
2023,District of Oak Bay,10-3619-00,V8S 4Z5,,648 TRANSIT,1653000,1242000,572000,1814000
2023,District of Oak Bay,10-3620-00,V8S 4Z5,,638 TRANSIT,1849000,1242000,789000,2031000
2023,District of Oak Bay,10-3622-00,V8S 2J5,,145 BARKLEY,2191000,2047000,590000,2637000
2023,District of Oak Bay,10-3623-00,V8S 2J5,,149 BARKLEY,2026000,1973000,450000,2423000
2023,District of Oak Bay,10-3625-00,V8R 5Y1,,2271 MUSGRAVE,1335000,1251000,199000,1450000
2023,District of Oak Bay,10-3626-00,V8R 5Y1,,2263 MUSGRAVE,1260000,1251000,124000,1375000
2023,District of Oak Bay,10-3627-00,V8R 2H7,,2516 DALHOUSIE,2801000,1558000,1604000,3162000
2023,District of Oak Bay,10-3628-00,V8R 2H7,,2526 DALHOUSIE,1555000,1534000,162000,1696000
2023,District of Oak Bay,10-3629-00,V8R 2H7,,2546 DALHOUSIE,2061000,1774000,473000,2247000
2023,District of Oak Bay,10-3630-00,V8R 5Y9,,2260 DUNLEVY,2601000,1623000,1265000,2888000
2023,District of Oak Bay,10-3631-00,V8R 5Y9,,2278 DUNLEVY,1617000,1623000,140000,1763000
2023,District of Oak Bay,10-3632-00,V8R 5Y9,,2296 DUNLEVY,1739000,1623000,273000,1896000
2023,District of Oak Bay,10-3632-00,V8R 5Y9,,2296 DUNLEVY,1739000,1623000,273000,1896000
2023,District of Oak Bay,10-3633-00,V8R 2G6,,2510 CAVENDISH,1661000,1610000,215000,1825000
2023,District of Oak Bay,10-3634-00,V8R 2G6,,2518 CAVENDISH,3059000,1647000,1826000,3473000
2023,District of Oak Bay,10-3635-00,V8R 2G6,,2528 CAVENDISH,2143000,1745000,617000,2362000
2023,District of Oak Bay,10-3636-00,V8R 2G6,,2540 CAVENDISH,1794000,1746000,246000,1992000
2023,District of Oak Bay,10-3637-00,V8R 2G6,,2550 CAVENDISH,2221000,1746000,708000,2454000
2023,District of Oak Bay,10-3638-00,V8R 2G6,,2562 CAVENDISH,1739000,1746000,156000,1902000
2023,District of Oak Bay,10-3639-00,V8R 2G6,,2574 CAVENDISH,1763000,1746000,185000,1931000
2023,District of Oak Bay,10-3640-00,V8R 2H8,,2587 DALHOUSIE,1932000,1733000,276000,2009000
2023,District of Oak Bay,10-3641-00,V8R 2H8,,2579 DALHOUSIE,1748000,1714000,199000,1913000
2023,District of Oak Bay,10-3642-00,V8R 2H8,,2571 DALHOUSIE,2132000,1695000,652000,2347000
2023,District of Oak Bay,10-3643-00,V8R 2H8,,2551 DALHOUSIE,1654000,1675000,135000,1810000
2023,District of Oak Bay,10-3644-00,V8R 2H8,,2543 DALHOUSIE,1960000,1655000,487000,2142000
2023,District of Oak Bay,10-3645-00,V8R 2H8,,2535 DALHOUSIE,1684000,1634000,211000,1845000
2023,District of Oak Bay,10-3646-00,V8R 2H8,,2527 DALHOUSIE,1672000,1522000,308000,1830000
2023,District of Oak Bay,10-3647-00,V8R 2H8,,2515 DALHOUSIE,1537000,1423000,250000,1673000
2023,District of Oak Bay,10-3648-00,V8R 3L3,,2536 THOMPSON,1750000,1703000,214000,1917000
2023,District of Oak Bay,10-3649-00,V8R 3L3,,2532 THOMPSON,1487000,1446000,176000,1622000
2023,District of Oak Bay,10-3650-00,V8R 5Y4,,2550 MUSGRAVE,1710000,1483000,397000,1880000
2023,District of Oak Bay,10-3651-00,V8S 4Y2,,1043 ST. PATRICK,1848000,1359000,1012000,2371000
2023,District of Oak Bay,10-3652-00,V8S 4Y2,,1061 ST. PATRICK,1953000,1768000,337000,2105000
2023,District of Oak Bay,10-3653-00,V8R 1G8,,2323 OAK BAY,1339000,1255000,182000,1437000
2023,District of Oak Bay,10-3653-00,V8R 1G8,,2323 OAK BAY,1339000,1255000,182000,1437000
2023,District of Oak Bay,10-3654-00,V8S 4Y4,,1464 ST. PATRICK,2071000,1402000,838000,2240000
2023,District of Oak Bay,10-3657-00,V8S 4X1,,1437 OLIVER,1851000,1653000,366000,2019000
2023,District of Oak Bay,10-3657-00,V8S 4X1,,1437 OLIVER,1851000,1653000,366000,2019000
2023,District of Oak Bay,10-3658-00,V8S 4X1,,1427 OLIVER,1663000,1403000,397000,1800000
2023,District of Oak Bay,10-3659-00,V8S 2C7,,1415 OLIVER,2015000,1403000,825000,2228000
2023,District of Oak Bay,10-3659-00,V8R 2H8,,1415 OLIVER,2015000,1403000,825000,2228000
2023,District of Oak Bay,10-3660-00,V8S 4X1,,1401 OLIVER,1606000,1402000,331000,1733000
2023,District of Oak Bay,10-3662-00,,,1360 ST. PATRICK,1684000,1510000,296000,1806000
2023,District of Oak Bay,10-3663-00,V8S 4Y4,,1382 ST. PATRICK,1777000,1509000,422000,1931000
2023,District of Oak Bay,10-3664-00,V8S 4Y4,, ST. PATRICK,123000,130000,0,130000
2023,District of Oak Bay,10-3665-00,V8S 4Y4,,1400 ST. PATRICK,2106000,1452000,791000,2243000
2023,District of Oak Bay,10-3666-00,V8S 4Y4,,1424 ST. PATRICK,1834000,1452000,537000,1989000
2023,District of Oak Bay,10-3670-00,V8S 2H5,,2070 PENZANCE,1508000,1481000,138000,1619000
2023,District of Oak Bay,10-3671-00,V8S 2H5,,2078 PENZANCE,1100700,1137000,49400,1186400
2023,District of Oak Bay,10-3672-00,V8S 2H5,,2082 PENZANCE,1103700,1137000,56400,1193400
2023,District of Oak Bay,10-3673-00,V8S 2H5,,2086 PENZANCE,1140500,1137000,88600,1225600
2023,District of Oak Bay,10-3674-00,V8S 2H5,,2090 PENZANCE,1348400,1393000,50800,1443800
2023,District of Oak Bay,10-3676-00,V8S 2J3,,31 MAQUINNA,2664300,2410000,95100,2505100
2023,District of Oak Bay,10-3677-00,V8S 2J3,,37 MAQUINNA,3573000,2250000,1311000,3561000
2023,District of Oak Bay,10-3679-00,V8R 1G2,,340 DENISON,541000,623000,0,623000
2023,District of Oak Bay,10-3680-00,V8S 2K6,,195 SUNNY,1511000,1436000,374000,1810000
2023,District of Oak Bay,10-3681-00,V8S 2K6,,207 SUNNY,3595000,1934000,2148000,4082000
2023,District of Oak Bay,10-3682-00,V8S 2K6,,217 SUNNY,1933000,1940000,367000,2307000
2023,District of Oak Bay,10-3684-00,V8S 2K6,,235 SUNNY,1507000,1574000,241000,1815000
2023,District of Oak Bay,10-3685-00,V8S 2K2,,350 KING GEORGE,1923000,2065000,258000,2323000
2023,District of Oak Bay,10-3688-00,V8S 2J8,,323 KING GEORGE,2204000,1904000,179000,2083000
2023,District of Oak Bay,10-3689-00,,,321 KING GEORGE,3481000,1848000,1596000,3444000
2023,District of Oak Bay,10-3690-00,V8S 2J3,,45 MAQUINNA,3592000,2747000,688000,3435000
2023,District of Oak Bay,10-3692-00,V8S 2J8,,307 KING GEORGE,2399000,2010000,202000,2212000
2023,District of Oak Bay,10-3693-00,L4N 7S4,,305 KING GEORGE,2670000,2059000,474000,2533000
2023,District of Oak Bay,10-3694-00,V8S 2J8,,299 KING GEORGE,2478400,2206000,149000,2355000
2023,District of Oak Bay,10-3695-00,V8S 2K2,,306 KING GEORGE,1619000,1633000,306000,1939000
2023,District of Oak Bay,10-3696-00,V8S 2K2,,296 KING GEORGE,1661000,1801000,195000,1996000
2023,District of Oak Bay,10-3697-00,V9L 5N6,,280 KING GEORGE,1654000,1676000,304000,1980000
2023,District of Oak Bay,10-3698-00,V8S 2K2,,290 KING GEORGE,1725000,1733000,350000,2083000
2023,District of Oak Bay,10-3699-00,V8S 2R3,,2130 CENTRAL,2636000,2220000,626000,2846000
2023,District of Oak Bay,10-3700-00,V8S 2R3,,2124 CENTRAL,1942000,1693000,409000,2102000
2023,District of Oak Bay,10-3701-00,V8S 2R3,,2114 CENTRAL,1901000,1514000,551000,2065000
2023,District of Oak Bay,10-3702-00,V8S 2R3,,2108 CENTRAL,2119000,1596000,470000,2066000
2023,District of Oak Bay,10-3703-00,V8S 4L9,,747 FALKLAND,1549000,1447000,221000,1668000
2023,District of Oak Bay,10-3704-00,V8S 4L9,,767 FALKLAND,1578000,1542000,170000,1712000
2023,District of Oak Bay,10-3708-00,V8R 5L7,,1757 ELGIN,1077100,1078000,90400,1168400
2023,District of Oak Bay,10-3709-00,V8R 5L7,,1763 ELGIN,1252000,1206000,156000,1362000
2023,District of Oak Bay,10-3710-00,V8R 5L7,,1769 ELGIN,1419000,1281000,287000,1568000
2023,District of Oak Bay,10-3710-00,V8R 5L7,,1769 ELGIN,1419000,1281000,287000,1568000
2023,District of Oak Bay,10-3711-01,V8R 5N6,,1690 YALE,1880000,1615000,455000,2070000
2023,District of Oak Bay,10-3713-00,V8R 5N6,,1686 YALE,1349000,1289000,164000,1453000
2023,District of Oak Bay,10-3714-00,V8R 5N6,,1684 YALE,2103000,1679000,630000,2309000
2023,District of Oak Bay,10-3716-00,V8R 6H6,,2120 OAK BAY,1671700,1652000,27400,1679400
2023,District of Oak Bay,10-3719-00,V0N 2W5,,1585 ELGIN,145000,157000,0,157000
2023,District of Oak Bay,10-3720-00,V8R 5L5,,1599 ELGIN,1040000,989000,164000,1153000
2023,District of Oak Bay,10-3721-00,V8R 5L5,,1613 ELGIN,1018300,1042000,69200,1111200
2023,District of Oak Bay,10-3722-00,V8R 5L5,,1627 ELGIN,1278000,1163000,215000,1378000
2023,District of Oak Bay,10-3723-00,V8N 4A8,,1649 ELGIN,1099000,1069000,171000,1240000
2023,District of Oak Bay,10-3726-00,V8R 5N4,,1606 YALE,1880000,1165000,910000,2075000
2023,District of Oak Bay,10-3727-00,V8R 5N4,,1596 YALE,1297000,1165000,255000,1420000
2023,District of Oak Bay,10-3728-00,V8R 5N4,,1584 YALE,1112000,1080000,148000,1228000
2023,District of Oak Bay,10-3729-00,V8R 5N4,,1576 YALE,1155000,1138000,138000,1276000
2023,District of Oak Bay,10-3730-00,V8R 5N4,,1566 YALE,1201000,1137000,194000,1331000
2023,District of Oak Bay,10-3731-00,V8R 5N4,,1558 YALE,1457000,1138000,477000,1615000
2023,District of Oak Bay,10-3732-00,V8R 5N4,,1550 YALE,1633000,1138000,641000,1779000
2023,District of Oak Bay,10-3733-00,V8R 5N4,,1542 YALE,1071900,1117000,57700,1174700
2023,District of Oak Bay,10-3734-00,V8R 5N4,,1534 YALE,1189000,1061000,254000,1315000
2023,District of Oak Bay,10-3735-00,V8R 1P2,,2290 WOODLAWN,3768000,2440000,1702000,4142000
2023,District of Oak Bay,10-3736-00,V8R 5X2,,1590 YORK,5304000,4060000,1651000,5711000
2023,District of Oak Bay,10-3742-00,V8V 3C5,,2010 LORNE,2140000,1396000,896000,2292000
2023,District of Oak Bay,10-3742-00,V8S 2H8,,2010 LORNE,2140000,1396000,896000,2292000
2023,District of Oak Bay,10-3743-00,V8S 2H8,,2002 LORNE,1319000,1259000,151000,1410000
2023,District of Oak Bay,10-3746-00,V8S 2V6,,2012 RUNNYMEDE,2202000,1697000,712000,2409000
2023,District of Oak Bay,10-3753-00,V8R 5H4,,2337 CADBORO BAY,1545000,1228000,454000,1682000
2023,District of Oak Bay,10-3754-00,V8R 2E6,,2329 CADBORO BAY,1197000,1186000,120000,1306000
2023,District of Oak Bay,10-3755-00,V8R 2E6,,2300 BOWKER,1004000,937000,170000,1107000
2023,District of Oak Bay,10-3756-00,V8R 2E6,,2334 BOWKER,1255000,1241000,127000,1368000
2023,District of Oak Bay,10-3757-00,V8R 6B9,,2342 BOWKER,1342000,1330000,135000,1465000
2023,District of Oak Bay,10-3761-00,V8R 5H6,,2434 CADBORO BAY,1127600,1124000,113000,1237000
2023,District of Oak Bay,10-3762-00,V8R 5H6,,2400 CADBORO BAY,1018400,1035000,71200,1106200
2023,District of Oak Bay,10-3763-00,V8R 5H6,,2420 CADBORO BAY,1237000,1196000,156000,1352000
2023,District of Oak Bay,10-3764-00,V8R 2M8,,2377 TOD,2339000,2153000,412000,2565000
2023,District of Oak Bay,10-3765-00,V8R 1G2,,2290 MUSGRAVE,10845000,3103000,9295000,12398000
2023,District of Oak Bay,10-3766-00,V8S 4S3,,775 HAMPSHIRE,1244500,1260000,79100,1339100
2023,District of Oak Bay,10-3767-00,V8S 4S3,,763 HAMPSHIRE,1321000,1255000,156000,1411000
2023,District of Oak Bay,10-3768-00,V8S 4S3,,755 HAMPSHIRE,1357000,1266000,197000,1463000
2023,District of Oak Bay,10-3772-00,V8S 4V2,,766 MONTEREY,1618000,1261000,493000,1754000
2023,District of Oak Bay,10-3773-00,V8S 4V2,,752 MONTEREY,2225000,1247000,1156000,2403000
2023,District of Oak Bay,10-3774-00,V8S 4V2,,772 MONTEREY,1304000,1260000,161000,1421000
2023,District of Oak Bay,10-3775-00,V8S 4P4,,1311 VICTORIA,1570000,1382000,316000,1698000
2023,District of Oak Bay,10-3776-00,V8S 2E7,,2144 BRIGHTON,833000,769000,133000,902000
2023,District of Oak Bay,10-3779-00,V8S 2E7,,2170 BRIGHTON,1501000,1248000,377000,1625000
2023,District of Oak Bay,10-3779-00,V8S 2E7,,2170 BRIGHTON,1501000,1248000,377000,1625000
2023,District of Oak Bay,10-3779-10,V8S 2E7,,2156 BRIGHTON,1859000,1165000,892000,2057000
2023,District of Oak Bay,10-3781-00,T5R 2Y3,,1229 OLIVER,1408200,1407000,122000,1529000
2023,District of Oak Bay,10-3782-00,V8S 4X1,,1209 OLIVER,1618000,1406000,341000,1747000
2023,District of Oak Bay,10-3783-00,V8S 4X1,,1199 OLIVER,1517000,1406000,226000,1632000
2023,District of Oak Bay,10-3784-00,V8R 3P4,,1198 ST. PATRICK,1455000,1407000,0,1407000
2023,District of Oak Bay,10-3785-00,V8S 4Y4,,1216 ST. PATRICK,1546000,1407000,266000,1673000
2023,District of Oak Bay,10-3786-00,V8S 4Y4,,1230 ST. PATRICK,1551000,1407000,267000,1674000
2023,District of Oak Bay,10-3787-00,V8S 4Z1,,1269 ST. DAVID,1980000,1552000,602000,2154000
2023,District of Oak Bay,10-3788-00,V8S 4Z1,,1275 ST. DAVID,1849000,1621000,382000,2003000
2023,District of Oak Bay,10-3788-00,V8S 4Z1,,1275 ST. DAVID,1849000,1621000,382000,2003000
2023,District of Oak Bay,10-3789-00,V8S 5A3,,1284 TRANSIT,3334000,1733000,1856000,3589000
2023,District of Oak Bay,10-3790-00,V8S 5A3,,1260 TRANSIT,2306000,1681000,809000,2490000
2023,District of Oak Bay,10-3791-00,V8R 1G2,,2037 CADBORO BAY,453000,522000,0,522000
2023,District of Oak Bay,10-3792-00,V8Z 1E8,,2121 CADBORO BAY,55298000,1344000,60730000,62074000
2023,District of Oak Bay,10-3793-00,V8Z 1E8,,2121 CADBORO BAY,70600,81300,0,81300
2023,District of Oak Bay,10-3794-00,V8Z 1E8,,2121 CADBORO BAY,5590000,5589000,0,5589000
2023,District of Oak Bay,10-3795-00,V8R 1G2,,2121 CADBORO BAY,831000,958000,0,958000
2023,District of Oak Bay,10-3796-00,V8R 1G2,, GOLDSMITH,1668000,1919000,0,1919000
2023,District of Oak Bay,10-3800-00,V8R 5T6,,1684 HAMPSHIRE,1571000,1515000,218000,1733000
2023,District of Oak Bay,10-3801-00,V8S 5M2,,1010 ISLAND,1364000,1253000,242000,1495000
2023,District of Oak Bay,10-3802-00,V8S 4Y2,,1033 ST. PATRICK,2054000,1478000,756000,2234000
2023,District of Oak Bay,10-3803-00,V8S 4Y2,,1025 ST. PATRICK,1453000,1390000,186000,1576000
2023,District of Oak Bay,10-3804-00,V8S 4Y2,,1017 ST. PATRICK,1722000,1486000,376000,1862000
2023,District of Oak Bay,10-3805-00,V8S 4Y8,,1060 ST. DAVID,1563000,1403000,294000,1697000
2023,District of Oak Bay,10-3806-00,V8S 4Y3,,1243 ST. PATRICK,1352000,1336000,136000,1472000
2023,District of Oak Bay,10-3807-00,V8S 4Y9,,1218 ST. DAVID,1918000,1704000,346000,2050000
2023,District of Oak Bay,10-3807-00,V8V 2P6,,1218 ST. DAVID,1918000,1704000,346000,2050000
2023,District of Oak Bay,10-3808-00,V8S 4Y9,,1238 ST. DAVID,1660000,1356000,416000,1772000
2023,District of Oak Bay,10-3809-00,V8R 1G1,,1248 ST. DAVID,1451000,1323000,273000,1596000
2023,District of Oak Bay,10-3811-00,V8S 4M6,,552 VICTORIA,1199800,1194000,105000,1299000
2023,District of Oak Bay,10-3812-00,V8S 4M6,,568 VICTORIA,1832000,1640000,322000,1962000
2023,District of Oak Bay,10-3813-00,V8S 4Y3,,1259 ST. PATRICK,1445000,1407000,145000,1552000
2023,District of Oak Bay,10-3814-00,V8S 4Y3,,1269 ST. PATRICK,1648000,1407000,388000,1795000
2023,District of Oak Bay,10-3815-00,V8S 4Y3,,1279 ST. PATRICK,1802000,1407000,564000,1971000
2023,District of Oak Bay,10-3816-00,V8S 4Y9,,1278 ST. DAVID,1619000,1405000,339000,1744000
2023,District of Oak Bay,10-3817-00,V8S 4Y9,,1268 ST. DAVID,1612000,1407000,326000,1733000
2023,District of Oak Bay,10-3818-00,V8S 4Y9,,1258 ST. DAVID,1448000,1406000,169000,1575000
2023,District of Oak Bay,10-3819-00,V8S 4T4,,1321 HAMPSHIRE,1338000,1235000,196000,1431000
2023,District of Oak Bay,10-3819-00,OX3 8AY,,1321 HAMPSHIRE,1338000,1235000,196000,1431000
2023,District of Oak Bay,10-3820-00,V8S 4T4,,1331 HAMPSHIRE,1191400,1225000,59600,1284600
2023,District of Oak Bay,10-3820-00,OX3 8AY,,1331 HAMPSHIRE,1191400,1225000,59600,1284600
2023,District of Oak Bay,10-3821-00,V8S 4T4,,1367 HAMPSHIRE,1681000,1244000,563000,1807000
2023,District of Oak Bay,10-3822-00,V8S 4T4,,1377 HAMPSHIRE,1768000,1521000,364000,1885000
2023,District of Oak Bay,10-3823-00,V8S 4T4,,1379 HAMPSHIRE,1583000,1522000,166000,1688000
2023,District of Oak Bay,10-3824-00,V8S 2E8,,2218 BRIGHTON,1613000,1494000,259000,1753000
2023,District of Oak Bay,10-3825-00,V8S 2E8,,2238 BRIGHTON,1618000,1494000,250000,1744000
2023,District of Oak Bay,10-3826-00,V8S 4V8,,1358 MONTEREY,2520000,1485000,1233000,2718000
2023,District of Oak Bay,10-3827-00,V8S 4V8,,1354 MONTEREY,2055000,1485000,741000,2226000
2023,District of Oak Bay,10-3828-00,V8S 4V8,,1330 MONTEREY,1355000,1235000,255000,1490000
2023,District of Oak Bay,10-3829-00,V8S 4V8,,1320 MONTEREY,1330000,1210000,217000,1427000
2023,District of Oak Bay,10-3830-00,V8S 4V8,,1316 MONTEREY,1468000,1258000,321000,1579000
2023,District of Oak Bay,10-3831-00,V8S 4Y3,,1229 ST. PATRICK,1512000,1296000,336000,1632000
2023,District of Oak Bay,10-3832-00,V8S 4Y3,,1217 ST. PATRICK,1545000,1296000,375000,1671000
2023,District of Oak Bay,10-3833-00,V8S 4Y3,,1205 ST. PATRICK,1457000,1296000,260000,1556000
2023,District of Oak Bay,10-3835-00,V8R 5K7,,3507 CADBORO BAY,2016000,1937000,231000,2168000
2023,District of Oak Bay,10-3836-00,V8Y 2X7,,3490 UPPER TERRACE,2205100,2342000,53300,2395300
2023,District of Oak Bay,10-3837-00,V8R 3N9,,2415 LANSDOWNE,1869000,1718000,356000,2074000
2023,District of Oak Bay,10-3838-00,V8R 3N9,,2445 LANSDOWNE,2122300,2252000,472000,2724000
2023,District of Oak Bay,10-3839-00,V8R 3N9,,2475 LANSDOWNE,3188000,1889000,1647000,3536000
2023,District of Oak Bay,10-3840-00,V8R 6B4,,3090 UPLANDS,2266500,2421000,35000,2456000
2023,District of Oak Bay,10-3841-00,V8R 6B4,,3080 UPLANDS,2448700,2592000,49700,2641700
2023,District of Oak Bay,10-3843-00,V8R 1G2,, CADBORO BAY,299000,344000,0,344000
2023,District of Oak Bay,10-3844-00,V8R 1G2,, LANSDOWNE,105000,123000,0,123000
2023,District of Oak Bay,10-3845-00,V8R 6G9,,3380 RIPON,7222000,3144000,4590000,7734000
2023,District of Oak Bay,10-3846-00,V8R 6G9,,3360 RIPON,4727000,3039000,1829000,4868000
2023,District of Oak Bay,10-3846-00,V8Y 3C4,,3360 RIPON,4727000,3039000,1829000,4868000
2023,District of Oak Bay,10-3847-00,V8R 6G7,,3340 RIPON,3171000,3070000,338000,3408000
2023,District of Oak Bay,10-3848-00,V8R 6G7,,3320 RIPON,3238000,2975000,477000,3452000
2023,District of Oak Bay,10-3851-00,V8R 6G3,,3235 MIDLAND,2816000,2674000,336000,3010000
2023,District of Oak Bay,10-3852-00,V8R 6G5,,3250 RIPON,2090300,2194000,46000,2240000
2023,District of Oak Bay,10-3853-00,V8R 6G5,,3230 RIPON,2302000,2147000,313000,2460000
2023,District of Oak Bay,10-3854-00,V8R 5K6,,3405 CADBORO BAY,2477000,2256000,384000,2640000
2023,District of Oak Bay,10-3856-00,V8R 3S7,,2460 CARDIGAN,7129000,2554000,4435000,6989000
2023,District of Oak Bay,10-3857-00,V8R 3S7,,2480 CARDIGAN,2877000,2092000,974000,3066000
2023,District of Oak Bay,10-3858-00,V8R 6B9,,3410 UPLANDS,2216000,2226000,159000,2385000
2023,District of Oak Bay,10-3858-00,V4X 2C2,,3410 UPLANDS,2216000,2226000,159000,2385000
2023,District of Oak Bay,10-3859-00,V8R 6B9,,3420 UPLANDS,2502000,2465000,227000,2692000
2023,District of Oak Bay,10-3860-00,V8R 3S8,,2465 CHILTERN,2793000,2515000,415000,2930000
2023,District of Oak Bay,10-3861-00,V8R 3S8,,2455 CHILTERN,3227000,2465000,977000,3442000
2023,District of Oak Bay,10-3862-00,V8R 5K6,,3415 CADBORO BAY,1964000,1632000,567000,2199000
2023,District of Oak Bay,10-3863-00,V8R 5K6,,3425 CADBORO BAY,1548200,1617000,63700,1680700
2023,District of Oak Bay,10-3864-00,V8R 5K7,,3445 CADBORO BAY,1680000,1611000,177000,1788000
2023,District of Oak Bay,10-3865-00,V8R 3S8,,2440 CHILTERN,2221000,2374000,30900,2404900
2023,District of Oak Bay,10-3865-00,V8R 3S8,,2440 CHILTERN,2221000,2374000,30900,2404900
2023,District of Oak Bay,10-3867-00,V8R 6E7,,3440 UPPER TERRACE,2978000,2612000,549000,3161000
2023,District of Oak Bay,10-3868-00,V8R 5K7,,3435 CADBORO BAY,1627000,1612000,126000,1738000
2023,District of Oak Bay,10-3869-00,V8R 6B9,,3430 UPLANDS,3857000,2495000,1737000,4232000
2023,District of Oak Bay,10-3870-01,,,923 FOUL BAY,1965000,1257000,918000,2175000
2023,District of Oak Bay,10-3870-05,V8S 4H9,,2050 EDGECLIFFE,4562000,2556000,2345000,4901000
2023,District of Oak Bay,10-3870-10,V8S 4H9,,2055 EDGECLIFFE,3781000,1846000,2150000,3996000
2023,District of Oak Bay,10-3870-15,V8S 4H9,,2045 EDGECLIFFE,3360000,1650000,1987000,3637000
2023,District of Oak Bay,10-3870-20,V8S 4H9,,2035 EDGECLIFFE,3072000,1735000,1605000,3340000
2023,District of Oak Bay,10-3872-00,V8S 4M2,,1030 FALKLAND,1444000,1364000,177000,1541000
2023,District of Oak Bay,10-3876-00,M4W 1V4,,1101 BEACH,10206000,7640000,1921000,9561000
2023,District of Oak Bay,10-3876-00,M5H 2M8,,1101 BEACH,10206000,7640000,1921000,9561000
2023,District of Oak Bay,10-3877-00,V8S 4W5,,713 OLIVER,2092000,1381000,877000,2258000
2023,District of Oak Bay,10-3878-00,V8S 4W5,,723 OLIVER,1586000,1298000,428000,1726000
2023,District of Oak Bay,10-3879-00,V8S 4W5,,733 OLIVER,1561000,1298000,411000,1709000
2023,District of Oak Bay,10-3880-00,V8R 5K4,,3395 CADBORO BAY,1786000,1886000,34700,1920700
2023,District of Oak Bay,10-3881-00,V8R 5K4,,3375 CADBORO BAY,1895100,1960000,91800,2051800
2023,District of Oak Bay,10-3882-00,V8R 3S4,,2455 CARDIGAN,2638700,2807000,37700,2844700
2023,District of Oak Bay,10-3883-00,V8R 3S6,,2475 CARDIGAN,4211000,2523000,1967000,4490000
2023,District of Oak Bay,10-3884-00,V8R 6B9,,3370 UPLANDS,5198000,2927000,2711000,5638000
2023,District of Oak Bay,10-3885-00,V8R 3T1,,3350 UPLANDS,3497000,3416000,443000,3859000
2023,District of Oak Bay,10-3886-00,V8R 6B9,,3300 UPLANDS,5784000,3566000,2745000,6311000
2023,District of Oak Bay,10-3887-00,V8R 6B7,,3200 UPLANDS,3480000,2738000,1095000,3833000
2023,District of Oak Bay,10-3888-00,V8R 3S2,,2460 COTSWOLD,4049000,2530000,1982000,4512000
2023,District of Oak Bay,10-3892-00,V8R 3S1,,2445 COTSWOLD,3564000,2203000,1845000,4048000
2023,District of Oak Bay,10-3893-00,V8R 3S1,,2455 COTSWOLD,2645000,2342000,442000,2784000
2023,District of Oak Bay,10-3894-00,V8R 3S1,,2475 COTSWOLD,3308000,2773000,705000,3478000
2023,District of Oak Bay,10-3895-00,V8R 6B5,,3160 UPLANDS,2809000,2682000,340000,3022000
2023,District of Oak Bay,10-3896-00,V8R 6B5,,3100 UPLANDS,2315800,2428000,56800,2484800
2023,District of Oak Bay,10-3899-00,V8R 1R7,,2733 SOMASS,4318000,2849000,1453000,4302000
2023,District of Oak Bay,10-3900-00,V8R 5K7,,3455 CADBORO BAY,2263000,2030000,377000,2407000
2023,District of Oak Bay,10-3901-00,V8R 5K7,,3465 CADBORO BAY,1913600,2007000,46900,2053900
2023,District of Oak Bay,10-3903-00,V6J 2E1,, RUTLAND,197000,214000,0,214000
2023,District of Oak Bay,10-3904-00,V8R 3T1,,2990 RUTLAND,2485000,2645000,36000,2681000
2023,District of Oak Bay,10-3905-00,V8R 3R3,,3035 LANSDOWNE,2319000,2068000,394000,2462000
2023,District of Oak Bay,10-3906-00,V8R 6L6,,3190 BEACH,2951000,2933000,249000,3182000
2023,District of Oak Bay,10-3906-00,V8N 2P4,,3190 BEACH,2951000,2933000,249000,3182000
2023,District of Oak Bay,10-3907-00,,,3170 BEACH,3065000,2741000,691000,3432000
2023,District of Oak Bay,10-3908-00,V8R 3P7,,2700 LANSDOWNE,4304000,2023000,2619000,4642000
2023,District of Oak Bay,10-3909-00,V8R 3P7,,2720 LANSDOWNE,1898200,2024000,23500,2047500
2023,District of Oak Bay,10-3910-00,V8T 2C1,,2660 LANSDOWNE,2980000,2638000,679000,3317000
2023,District of Oak Bay,10-3913-00,V8R 3S3,,2605 COTSWOLD,2210000,2318000,48500,2366500
2023,District of Oak Bay,10-3914-00,V8R 6B4,,3070 UPLANDS,2050700,2153000,70600,2223600
2023,District of Oak Bay,10-3915-00,V8R 6B4,,3060 UPLANDS,2223000,2064000,407000,2471000
2023,District of Oak Bay,10-3916-00,V8R 6B3,,3055 UPLANDS,2849000,2848000,230000,3078000
2023,District of Oak Bay,10-3917-00,V8R 6B3,,3065 UPLANDS,2881000,2611000,599000,3210000
2023,District of Oak Bay,10-3918-00,V8R 6B3,,3075 UPLANDS,4355000,2625000,2058000,4683000
2023,District of Oak Bay,10-3919-00,V8R 6B3,,3085 UPLANDS,2243600,2383000,34500,2417500
2023,District of Oak Bay,10-3920-00,V8R 3P2,,2525 LANSDOWNE,4590000,2460000,2563000,5023000
2023,District of Oak Bay,10-3921-00,V8R 3S3,,2555 COTSWOLD,2333200,2477000,39300,2516300
2023,District of Oak Bay,10-3921-00,V8R 6B4,,2555 COTSWOLD,2333200,2477000,39300,2516300
2023,District of Oak Bay,10-3922-00,V8R 6E1,,3160 WEALD,4885000,2502000,2871000,5373000
2023,District of Oak Bay,10-3923-00,V8R 6E1,,3130 WEALD,3214000,2531000,1057000,3588000
2023,District of Oak Bay,10-3924-00,V8R 6E1,,3110 WEALD,2459000,2142000,616000,2758000
2023,District of Oak Bay,10-3925-00,V8R 3P3,,2580 LANSDOWNE,2260000,1968000,589000,2557000
2023,District of Oak Bay,10-3926-00,V8R 3P3,,2530 LANSDOWNE,2341100,2497000,31500,2528500
2023,District of Oak Bay,10-3927-00,V8R 6B6,,3155 UPLANDS,1820700,1913000,41600,1954600
2023,District of Oak Bay,10-3928-00,V8R 3S3,,2505 COTSWOLD,2358600,2495000,0,2495000
2023,District of Oak Bay,10-3929-00,V8R 3S3,,2515 COTSWOLD,1739200,1847000,28100,1875100
2023,District of Oak Bay,10-3930-00,V8R 3S3,,2535 COTSWOLD,6237000,2770000,3743000,6513000
2023,District of Oak Bay,10-3931-00,V8R 3P4,,2655 LANSDOWNE,1896000,2022000,32400,2054400
2023,District of Oak Bay,10-3932-00,V8R 3P4,,2695 LANSDOWNE,3801000,2022000,2129000,4151000
2023,District of Oak Bay,10-3933-00,V8W 2R9,,2725 LANSDOWNE,3984000,2224000,2324000,4548000
2023,District of Oak Bay,10-3934-00,V8R 3P6,,2755 LANSDOWNE,3149000,2224000,1334000,3558000
2023,District of Oak Bay,10-3935-00,V8R 3P8,,2855 LANSDOWNE,2271700,2400000,41400,2441400
2023,District of Oak Bay,10-3936-00,V8R 3P8,,2875 LANSDOWNE,5072000,2670000,2831000,5501000
2023,District of Oak Bay,10-3937-00,V8R 3M7,,2540 DORSET,2362800,2496000,48100,2544100
2023,District of Oak Bay,10-3938-00,V8R 6K7,,2800 BEACH,2601000,2367000,417000,2784000
2023,District of Oak Bay,10-3939-00,V8R 6K7,,2860 BEACH,2827000,2554000,467000,3021000
2023,District of Oak Bay,10-3941-00,V8S 2K8,,24 SYLVAN,2722000,2796000,484000,3280000
2023,District of Oak Bay,10-3942-00,V8S 4Y8,,1012 ST. DAVID,1295000,1228000,163000,1391000
2023,District of Oak Bay,10-3943-00,V8S 4Y8,,1018 ST. DAVID,1538000,1359000,300000,1659000
2023,District of Oak Bay,10-3944-00,V8S 4Y8,,1024 ST. DAVID,1502000,1359000,263000,1622000
2023,District of Oak Bay,10-3945-00,V8S 4Y8,,1034 ST. DAVID,1404000,1358000,156000,1514000
2023,District of Oak Bay,10-3946-00,V8S 4Y8,,1042 ST. DAVID,1625000,1370000,381000,1751000
2023,District of Oak Bay,10-3947-00,V8S 4Y8,,1050 ST. DAVID,1509000,1346000,271000,1617000
2023,District of Oak Bay,10-3948-00,V8R 6L3,,3045 BEACH,6184000,4213000,2622000,6835000
2023,District of Oak Bay,10-3950-00,V8R 3N8,,3150 TARN,8168000,5989000,70600,6059600
2023,District of Oak Bay,10-3953-00,V8R 6K6,,2715 BEACH,3181000,2712000,724000,3436000
2023,District of Oak Bay,10-3954-00,V8R 6K6,,2745 BEACH,3322000,2937000,771000,3708000
2023,District of Oak Bay,10-3955-00,L9H 2X7,,2775 BEACH,2732000,2974000,0,2974000
2023,District of Oak Bay,10-3957-00,V8R 6K8,,2835 BEACH,3491000,2958000,703000,3661000
2023,District of Oak Bay,10-3957-00,V8R 6K8,,2835 BEACH,3491000,2958000,703000,3661000
2023,District of Oak Bay,10-3958-00,V8R 6K8,,2855 BEACH,3468700,3643000,36700,3679700
2023,District of Oak Bay,10-3959-00,V8R 6K8,,2875 BEACH,6393000,3715000,2648000,6363000
2023,District of Oak Bay,10-3960-00,T5H 2Z9,,2895 BEACH,3115000,3093000,191000,3284000
2023,District of Oak Bay,10-3960-00,,,2895 BEACH,3115000,3093000,191000,3284000
2023,District of Oak Bay,10-3961-00,V8R 2W4,,2750 THORPE,4791000,3484000,1819000,5303000
2023,District of Oak Bay,10-3962-00,V8R 2W4,,2730 THORPE,5068000,3379000,2063000,5442000
2023,District of Oak Bay,10-3963-00,V8R 2W4,,2710 THORPE,5231000,3275000,2230000,5505000
2023,District of Oak Bay,10-3964-00,V8S 4X8,,907 ST. PATRICK,1472000,1281000,309000,1590000
2023,District of Oak Bay,10-3965-00,V8S 4X8,,919 ST. PATRICK,1348600,1358000,90400,1448400
2023,District of Oak Bay,10-3966-00,,,141 BARKLEY,2288000,2338000,418000,2756000
2023,District of Oak Bay,10-3967-00,V8S 2H1,,1934 CRESCENT,2045000,1974000,453000,2427000
2023,District of Oak Bay,10-3967-01,V8R 1G2,, CRESCENT,32300,37200,0,37200
2023,District of Oak Bay,10-3972-00,V8S 2L2,,4 BEACH,1655000,1703000,282000,1985000
2023,District of Oak Bay,11-3973-00,V8R 6J6,,2000 BEACH,1756000,1499000,432000,1931000
2023,District of Oak Bay,11-3974-00,V8R 6J6,,2032 BEACH,1639000,1499000,297000,1796000
2023,District of Oak Bay,11-3975-00,V8R 6J6,,2044 BEACH,1620000,1498000,285000,1783000
2023,District of Oak Bay,11-3982-00,V8R 5J9,,2840 CADBORO BAY,1405000,1243000,289000,1532000
2023,District of Oak Bay,11-3984-00,V8S 2M5,,2423 CENTRAL,1481000,1525000,244000,1769000
2023,District of Oak Bay,11-3984-00,V8S 2M5,,2423 CENTRAL,1481000,1525000,244000,1769000
2023,District of Oak Bay,11-3985-00,V8S 2S7,,2433 CENTRAL,1470000,1525000,230000,1755000
2023,District of Oak Bay,11-3986-00,V8S 2T6,,686 ISLAND,1708000,1528000,495000,2023000
2023,District of Oak Bay,11-3990-00,V8S 2T6,,638 ISLAND,2090000,1728000,754000,2482000
2023,District of Oak Bay,11-3991-00,V8S 2T6,,634 ISLAND,2227000,1729000,945000,2674000
2023,District of Oak Bay,11-3992-00,V8S 2T6,,630 ISLAND,2610000,2019000,939000,2958000
2023,District of Oak Bay,11-3993-00,V8S 4Z4,,577 TRANSIT,2001000,1711000,674000,2385000
2023,District of Oak Bay,11-3993-00,V8S 4Z4,,577 TRANSIT,2001000,1711000,674000,2385000
2023,District of Oak Bay,11-3994-02,V8S 4Z4,,601 TRANSIT,2009000,1728000,640000,2368000
2023,District of Oak Bay,11-3994-03,V8S 4Z4,,587 TRANSIT,3290000,1728000,2062000,3790000
2023,District of Oak Bay,11-3996-00,V8S 4Z4,,619 TRANSIT,2206000,1759000,864000,2623000
2023,District of Oak Bay,11-3996-01,V8R 1G2,, TRANSIT,10100,11600,0,11600
2023,District of Oak Bay,11-3997-00,V8S 4Z4,,637 TRANSIT,2166000,1728000,819000,2547000
2023,District of Oak Bay,11-3998-00,V5K 1A6,,645 TRANSIT,1656000,1726000,249000,1975000
2023,District of Oak Bay,11-3999-00,V8S 4Z4,,651 TRANSIT,2118000,1726000,785000,2511000
2023,District of Oak Bay,11-4000-00,V8S 4Z4,,661 TRANSIT,1789000,1726000,406000,2132000
2023,District of Oak Bay,11-4001-00,V8S 2T7,,687 ISLAND,1675000,1459000,531000,1990000
2023,District of Oak Bay,11-4002-10,V8S 2T7,,671 ISLAND,4267000,2312000,2512000,4824000
2023,District of Oak Bay,11-4002-20,V8S 2T7,,679 ISLAND,1488000,1543000,249000,1792000
2023,District of Oak Bay,11-4005-00,V8S 2S9,,2487 CENTRAL,1640000,1462000,463000,1925000
2023,District of Oak Bay,11-4006-00,V8S 2S9,,2491 CENTRAL,1571000,1462000,422000,1884000
2023,District of Oak Bay,11-4007-10,V8R 1R8,,2760 SOMASS,2523000,1969000,916000,2885000
2023,District of Oak Bay,11-4007-20,V8R 1R8,,2800 SOMASS,2207000,2078000,332000,2410000
2023,District of Oak Bay,11-4008-00,V6E 4P3,,2720 SOMASS,2280000,2087000,406000,2493000
2023,District of Oak Bay,11-4009-00,V8R 6J4,,1823 BEACH,2165000,1981000,412000,2393000
2023,District of Oak Bay,11-4010-00,V6P 6R3,,1833 BEACH,2485000,2314000,429000,2743000
2023,District of Oak Bay,11-4011-00,V8S 2K8,, SYLVAN,6100,7400,0,7400
2023,District of Oak Bay,11-4013-00,V8S 2L3,,71 BEACH,2370000,2437000,392000,2829000
2023,District of Oak Bay,11-4014-00,V8S 3E7,,2396 WINDSOR,2316000,1259000,1362000,2621000
2023,District of Oak Bay,11-4015-00,V8S 5A3,,1140 TRANSIT,1170900,1183000,74700,1257700
2023,District of Oak Bay,11-4016-00,V8S 5A3,,1152 TRANSIT,1239000,1167000,176000,1343000
2023,District of Oak Bay,11-4017-00,V8S 2L2,,40 BEACH,1484300,1805000,300,1805300
2023,District of Oak Bay,11-4018-00,V8S 2L2,,30 BEACH,1622000,1664000,271000,1935000
2023,District of Oak Bay,11-4019-00,V8S 2L2,,16 BEACH,1746000,1767000,314000,2081000
2023,District of Oak Bay,11-4020-00,V8S 2M5,,10 BEACH,1544000,1575000,278000,1853000
2023,District of Oak Bay,11-4020-00,V8S 2M5,,10 BEACH,1544000,1575000,278000,1853000
2023,District of Oak Bay,11-4021-00,V8S 4K9,,670 MOUNTJOY,2737000,2779000,495000,3274000
2023,District of Oak Bay,11-4021-00,V8S 4K9,,670 MOUNTJOY,2737000,2779000,495000,3274000
2023,District of Oak Bay,11-4024-00,V8S 4K9,,650 MOUNTJOY,1719000,1745000,336000,2081000
2023,District of Oak Bay,11-4027-00,V8S 2N2,,975 BEACH,7242000,4067000,3001000,7068000
2023,District of Oak Bay,11-4029-00,V8S 2M8,,685 BEACH,3290000,2820000,229000,3049000
2023,District of Oak Bay,11-4030-00,V8S 2M8,,677 BEACH,4121000,2483000,1761000,4244000
2023,District of Oak Bay,11-4031-00,V8S 2M8,,669 BEACH,4629000,2834000,2438000,5272000
2023,District of Oak Bay,11-4032-00,V8S 2M8,,661 BEACH,2987000,2651000,844000,3495000
2023,District of Oak Bay,11-4033-00,V8S 2M8,,651 BEACH,3034000,2671000,927000,3598000
2023,District of Oak Bay,11-4034-00,V8S 2M8,,643 BEACH,2304000,2505000,201000,2706000
2023,District of Oak Bay,11-4035-00,V8S 2M8,,637 BEACH,2318000,2172000,539000,2711000
2023,District of Oak Bay,11-4039-00,V8S 5B7,,627 HOOD,4501000,3112000,1259000,4371000
2023,District of Oak Bay,11-4040-00,V8S 2J8,,295 KING GEORGE,4337000,2583000,1642000,4225000
2023,District of Oak Bay,11-4043-00,V8R 2M8,,2397 TOD,1518000,1458000,200000,1658000
2023,District of Oak Bay,11-4044-00,V8R 1G2,, TOD,588000,689000,0,689000
2023,District of Oak Bay,11-4045-00,V8R 1G2,, TOD,582000,680000,0,680000
2023,District of Oak Bay,11-4046-00,V8R 1G2,, TOD,575000,673000,0,673000
2023,District of Oak Bay,11-4047-00,V8S 2K8,,6 SYLVAN,2082000,2119000,374000,2493000
2023,District of Oak Bay,11-4048-10,V8R 5X4,,1705 MONTEITH,1958000,1410000,804000,2214000
2023,District of Oak Bay,11-4048-20,V8R 1P4,,2414 SAN CARLOS,1841000,1425000,589000,2014000
2023,District of Oak Bay,11-4049-00,V8R 1P4,,2408 SAN CARLOS,1828000,1459000,580000,2039000
2023,District of Oak Bay,11-4050-00,V8R 1P4,,2402 SAN CARLOS,1824000,1459000,566000,2025000
2023,District of Oak Bay,11-4051-00,V8R 1P4,,2396 SAN CARLOS,1831000,1460000,579000,2039000
2023,District of Oak Bay,11-4052-00,V8R 1P4,,2390 SAN CARLOS,1893000,1509000,585000,2094000
2023,District of Oak Bay,11-4054-00,V8R 1P4,, PATIO,17900,19200,0,19200
2023,District of Oak Bay,11-4055-00,V8S 2T9,,778 ISLAND,1746000,1589000,279000,1868000
2023,District of Oak Bay,11-4056-00,V8S 2T9,,786 ISLAND,1782000,1586000,333000,1919000
2023,District of Oak Bay,11-4057-00,V8S 3B6,,2483 CURRIE,1616000,1515000,227000,1742000
2023,District of Oak Bay,11-4062-00,V8S 2V2,,1011 ISLAND,1641000,1358000,380000,1738000
2023,District of Oak Bay,11-4063-00,V8S 2Z4,,2468 MCNEILL,1421000,1301000,230000,1531000
2023,District of Oak Bay,11-4063-00,V8S 2Z4,,2468 MCNEILL,1421000,1301000,230000,1531000
2023,District of Oak Bay,11-4067-00,V8S 3B6,,2493 CURRIE,1488000,1319000,279000,1598000
2023,District of Oak Bay,11-4068-00,V8S 5B6,,1180 ST. LOUIS,1449000,1327000,230000,1557000
2023,District of Oak Bay,11-4069-00,V8S 5E2,,1041 NEWPORT,1643000,1591000,172000,1763000
2023,District of Oak Bay,11-4069-00,V8S 5E2,,1041 NEWPORT,1643000,1591000,172000,1763000
2023,District of Oak Bay,11-4070-00,V8S 5E2,,1031 NEWPORT,1807000,1554000,394000,1948000
2023,District of Oak Bay,11-4071-00,V8S 3A5,,2620 MARGATE,1795000,1615000,283000,1898000
2023,District of Oak Bay,11-4072-00,V8S 3A5,,2630 MARGATE,1642000,1585000,178000,1763000
2023,District of Oak Bay,11-4073-00,V8S 3A5,,2640 MARGATE,1350000,1269000,172000,1441000
2023,District of Oak Bay,11-4074-00,V8S 5G5,,1008 DEAL,1725000,1285000,615000,1900000
2023,District of Oak Bay,11-4075-00,V8S 5G5,,1016 DEAL,2205000,1293000,1185000,2478000
2023,District of Oak Bay,11-4076-00,V8S 5G5,,1024 DEAL,1679000,1328000,474000,1802000
2023,District of Oak Bay,11-4077-00,V8S 5E2,,1047 NEWPORT,2775000,1410000,1689000,3099000
2023,District of Oak Bay,11-4080-00,V8R 6E6,,3210 UPPER TERRACE,3677000,2198000,1913000,4111000
2023,District of Oak Bay,11-4081-00,V8R 6E6,,3230 UPPER TERRACE,3268000,2234000,1450000,3684000
2023,District of Oak Bay,11-4082-00,T5K 2K7,,3250 UPPER TERRACE,2371000,2288000,243000,2531000
2023,District of Oak Bay,11-4083-00,V8R 3P4,,3320 UPPER TERRACE,2362000,2197000,391000,2588000
2023,District of Oak Bay,11-4084-00,V8R 6E6,,3350 UPPER TERRACE,2381000,2074000,439000,2513000
2023,District of Oak Bay,11-4085-00,V8R 6E6,,3380 UPPER TERRACE,2702000,2124000,965000,3089000
2023,District of Oak Bay,11-4086-00,V8R 6E6,,3400 UPPER TERRACE,1985000,1957000,180000,2137000
2023,District of Oak Bay,11-4087-00,T2N 1Z4,,3395 WEALD,4082000,1991000,2529000,4520000
2023,District of Oak Bay,11-4087-00,V8V 3X1,,3395 WEALD,4082000,1991000,2529000,4520000
2023,District of Oak Bay,11-4088-00,V8R 6E4,,3375 WEALD,1728200,1852000,22100,1874100
2023,District of Oak Bay,11-4089-00,V8R 6E8,,3355 WEALD,2066000,1802000,370000,2172000
2023,District of Oak Bay,11-4090-00,V8R 6E4,,3335 WEALD,3003000,1937000,1407000,3344000
2023,District of Oak Bay,11-4091-00,V8R 6E4,,3305 WEALD,2037000,1915000,262000,2177000
2023,District of Oak Bay,11-4092-00,V8R 6E4,,3285 WEALD,1955500,2075000,33000,2108000
2023,District of Oak Bay,11-4093-00,V8R 6E4,,3235 WEALD,2238000,2174000,235000,2409000
2023,District of Oak Bay,11-4094-00,V8R 3S4,,2500 COTSWOLD,2180000,2310000,38000,2348000
2023,District of Oak Bay,11-4095-00,V8R 3S4,,2520 COTSWOLD,3630000,2279000,1641000,3920000
2023,District of Oak Bay,11-4096-00,V8R 3S4,,2540 COTSWOLD,2097900,2249000,31600,2280600
2023,District of Oak Bay,11-4097-00,V8R 3S4,,2560 COTSWOLD,2397000,2330000,244000,2574000
2023,District of Oak Bay,11-4098-00,V8R 3S4,,2580 COTSWOLD,2221000,2186000,204000,2390000
2023,District of Oak Bay,11-4099-00,V8R 6E3,,3220 WEALD,5425000,2511000,3260000,5771000
2023,District of Oak Bay,11-4100-00,V8R 6E3,,3250 WEALD,2567000,2321000,420000,2741000
2023,District of Oak Bay,11-4101-00,V8R 6E3,,3280 WEALD,4336000,2164000,2613000,4777000
2023,District of Oak Bay,11-4102-00,V8R 6E3,,3320 WEALD,2263000,2100000,322000,2422000
2023,District of Oak Bay,11-4103-00,V8R 6E3,,3350 WEALD,4443000,2266000,2542000,4808000
2023,District of Oak Bay,11-4104-00,V8R 6B8,,3375 UPLANDS,2327000,2232000,270000,2502000
2023,District of Oak Bay,11-4105-00,V8R 6B8,,3355 UPLANDS,2818000,2203000,359000,2562000
2023,District of Oak Bay,11-4106-00,V8R 6B8,,3335 UPLANDS,2345000,2181000,313000,2494000
2023,District of Oak Bay,11-4107-00,,,3295 UPLANDS,2455000,2282000,356000,2638000
2023,District of Oak Bay,11-4108-00,V8R 6B8,,3275 UPLANDS,2417000,2437000,1531000,3968000
2023,District of Oak Bay,11-4109-00,V8R 6B7,,3255 UPLANDS,2820000,2496000,511000,3007000
2023,District of Oak Bay,11-4110-00,V8R 6B8,,3225 UPLANDS,2400700,2542000,51700,2593700
2023,District of Oak Bay,11-4111-00,V8R 3P2,,2595 LANSDOWNE,2768000,2500000,577000,3077000
2023,District of Oak Bay,11-4112-00,V8R 6C5,,2580 NOTTINGHAM,2153000,1935000,495000,2430000
2023,District of Oak Bay,11-4114-00,V8S 4K8,,679 MOUNTJOY,2499000,2015000,958000,2973000
2023,District of Oak Bay,11-4115-00,V8S 4K8,,659 MOUNTJOY,2071000,2005000,456000,2461000
2023,District of Oak Bay,11-4116-00,V8S 4K8,,649 MOUNTJOY,1943000,1925000,407000,2332000
2023,District of Oak Bay,11-4117-00,V8S 4K8,,629 MOUNTJOY,1968000,1905000,458000,2363000
2023,District of Oak Bay,11-4118-00,V8S 2L4,,50 BEACH,1831000,1520000,651000,2171000
2023,District of Oak Bay,11-4119-00,V8S 2L4,,60 BEACH,1959000,1919000,409000,2328000
2023,District of Oak Bay,11-4120-00,V8S 4L5,,688 FALKLAND,2112000,1910000,608000,2518000
2023,District of Oak Bay,11-4121-00,V8S 4L5,,668 FALKLAND,1900000,1880000,373000,2253000
2023,District of Oak Bay,11-4122-00,V8S 4L5,,648 FALKLAND,1781000,1956000,185000,2141000
2023,District of Oak Bay,11-4123-00,V8S 4L5,,630 FALKLAND,2120000,1947000,496000,2443000
2023,District of Oak Bay,11-4123-01,V8S 4L5,,620 FALKLAND,2112000,1869000,657000,2526000
2023,District of Oak Bay,11-4124-00,V8S 4L5,,592 FALKLAND,1766000,1849000,263000,2112000
2023,District of Oak Bay,11-4125-00,V8R 6S4,,562 FALKLAND,2806000,1850000,2122000,3972000
2023,District of Oak Bay,11-4127-00,T2G 0R5,,70 BEACH,1956000,1661000,641000,2302000
2023,District of Oak Bay,11-4130-00,V8S 4H9,,1039 FOUL BAY,1372000,1106000,382000,1488000
2023,District of Oak Bay,11-4131-00,V8S 4H9,,1037 FOUL BAY,1264000,1032000,357000,1389000
2023,District of Oak Bay,11-4133-00,V8R 3P8,,2895 LANSDOWNE,2868000,2775000,275000,3050000
2023,District of Oak Bay,11-4133-00,V6N 3W9,,2895 LANSDOWNE,2868000,2775000,275000,3050000
2023,District of Oak Bay,11-4134-00,V8R 6H3,,3085 SOUTHDOWNE,4942000,2445000,3864000,6309000
2023,District of Oak Bay,11-4135-00,V8R 6H3,,3075 SOUTHDOWNE,3229000,2465000,1155000,3620000
2023,District of Oak Bay,11-4136-00,V8R 3R1,,2925 LANSDOWNE,2684000,2531000,333000,2864000
2023,District of Oak Bay,11-4137-00,V8R 3N4,,2960 SURREY,2542000,2545000,200000,2745000
2023,District of Oak Bay,11-4138-00,V8R 6L2,,3000 BEACH,2838000,2770000,281000,3051000
2023,District of Oak Bay,11-4139-00,V8R 6L2,,3030 BEACH,3875000,2554000,1583000,4137000
2023,District of Oak Bay,11-4142-00,V8R 3N6,,3015 VALDEZ,5202000,2783000,2703000,5486000
2023,District of Oak Bay,11-4143-00,V8V 2X7,,3000 VALDEZ,3247000,2675000,3059000,5734000
2023,District of Oak Bay,11-4144-00,V8R 3N7,,3020 VALDEZ,2115800,2255000,30500,2285500
2023,District of Oak Bay,11-4145-00,V8R 3N7,,3046 VALDEZ,3359000,1992000,1820000,3812000
2023,District of Oak Bay,11-4146-00,V8R 6L4,,3050 BEACH,4549000,2654000,2368000,5022000
2023,District of Oak Bay,11-4147-00,V8R 6L4,,3080 BEACH,2174900,2300000,39400,2339400
2023,District of Oak Bay,11-4148-00,V8R 3R5,,3055 RUTLAND,2793000,2074000,874000,2948000
2023,District of Oak Bay,11-4149-00,V8R 3R5,,3025 RUTLAND,2347000,2035000,424000,2459000
2023,District of Oak Bay,11-4150-00,V8R 3R5,,3005 RUTLAND,3424000,2793000,808000,3601000
2023,District of Oak Bay,11-4151-00,V8R 3R5,,2985 RUTLAND,2692000,2456000,425000,2881000
2023,District of Oak Bay,11-4152-00,V8R 3R5,,2955 RUTLAND,2580000,2356000,392000,2748000
2023,District of Oak Bay,11-4153-00,V8R 6K9,,2970 BEACH,6216000,3352000,3328000,6680000
2023,District of Oak Bay,11-4156-00,,,3000 UPLANDS,2567000,1782000,1145000,2927000
2023,District of Oak Bay,11-4157-00,V8R 6B1,,3020 UPLANDS,2373000,1945000,701000,2646000
2023,District of Oak Bay,11-4158-00,V8R 2A2,,2646 CRANMORE,2225000,1581000,902000,2483000
2023,District of Oak Bay,11-4159-00,V8R 2A2,,2670 CRANMORE,2682000,1581000,1363000,2944000
2023,District of Oak Bay,11-4160-00,V8R 6G6,,3335 RIPON,2227800,2345000,38300,2383300
2023,District of Oak Bay,11-4161-00,V8R 6G6,,3315 RIPON,2045900,2175000,31900,2206900
2023,District of Oak Bay,11-4162-00,V8R 6G6,,3295 RIPON,2630000,2405000,404000,2809000
2023,District of Oak Bay,11-4163-00,V8R 5K7,,3275 RIPON,2442400,2587000,43300,2630300
2023,District of Oak Bay,11-4164-00,V8R 6G6,,3245 RIPON,3179000,2633000,738000,3371000
2023,District of Oak Bay,11-4165-00,V8R 6G6,,3225 RIPON,3147000,2819000,529000,3348000
2023,District of Oak Bay,11-4166-00,V8R 6H4,,3215 RIPON,3068000,3095000,234000,3329000
2023,District of Oak Bay,11-4167-00,V8R 6G4,,3185 RIPON,2975000,2736000,445000,3181000
2023,District of Oak Bay,11-4168-00,T4N 1C7,,3175 RIPON,4147000,2552000,2105000,4657000
2023,District of Oak Bay,11-4169-00,V8R 6G4,,3165 RIPON,2627000,2488000,318000,2806000
2023,District of Oak Bay,11-4170-00,V8R 1G1,,3155 RIPON,2954000,2581000,537000,3118000
2023,District of Oak Bay,11-4171-00,V8R 1G1,,3145 RIPON,2886000,2765000,326000,3091000
2023,District of Oak Bay,11-4172-00,V8R 6G4,,3135 RIPON,3033000,2929000,306000,3235000
2023,District of Oak Bay,11-4173-00,V9B 2A5,,2810 LANSDOWNE,4946000,2545000,2912000,5457000
2023,District of Oak Bay,11-4174-00,V8R 3P9,,2830 LANSDOWNE,2641000,2583000,246000,2829000
2023,District of Oak Bay,11-4175-00,V8R 3P9,,2850 LANSDOWNE,2644000,2587000,250000,2837000
2023,District of Oak Bay,11-4176-00,V8R 3P9,,2870 LANSDOWNE,2563000,2549000,212000,2761000
2023,District of Oak Bay,11-4177-00,V8R 3P9,,2880 LANSDOWNE,4392000,2614000,2423000,5037000
2023,District of Oak Bay,11-4178-00,V8R 3P9,,2890 LANSDOWNE,2707000,2565000,339000,2904000
2023,District of Oak Bay,11-4179-00,V8R 6H4,,3110 NORFOLK,2890000,2760000,345000,3105000
2023,District of Oak Bay,11-4180-00,V8R 6H4,,3130 NORFOLK,2698000,2609000,286000,2895000
2023,District of Oak Bay,11-4181-00,V8R 6H4,,3150 NORFOLK,2860000,2480000,591000,3071000
2023,District of Oak Bay,11-4182-00,V8S 4T8,,3170 NORFOLK,2226700,2388000,24100,2412100
2023,District of Oak Bay,11-4183-00,V8R 6H4,,3180 NORFOLK,2473000,2377000,272000,2649000
2023,District of Oak Bay,11-4184-00,V8R 6H4,,3190 NORFOLK,4133000,2443000,2278000,4721000
2023,District of Oak Bay,11-4185-00,V8R 6H4,,3200 NORFOLK,2677000,2546000,319000,2865000
2023,District of Oak Bay,11-4186-00,V8R 6H4,,3220 NORFOLK,2596000,2505000,274000,2779000
2023,District of Oak Bay,11-4187-00,V8R 6B9,,3240 NORFOLK,2227800,2384000,26800,2410800
2023,District of Oak Bay,11-4188-00,V8R 6H4,,3250 NORFOLK,2297000,2235000,225000,2460000
2023,District of Oak Bay,11-4189-00,V8R 6H4,,3270 NORFOLK,2393000,2213000,333000,2546000
2023,District of Oak Bay,11-4190-00,V8R 6H4,,3290 NORFOLK,4367000,2180000,2634000,4814000
2023,District of Oak Bay,11-4191-00,V8R 6H4,,3300 NORFOLK,2387000,2222000,321000,2543000
2023,District of Oak Bay,11-4192-00,V8R 6G8,,3375 RIPON,6165000,2745000,3660000,6405000
2023,District of Oak Bay,11-4193-00,V8Z 6T8,,3355 NORFOLK,4063000,2699000,1860000,4559000
2023,District of Oak Bay,11-4194-00,V8R 6H5,,3335 NORFOLK,3374000,2840000,730000,3570000
2023,District of Oak Bay,11-4195-00,V8R 6H5,,3315 NORFOLK,3115000,2763000,502000,3265000
2023,District of Oak Bay,11-4196-00,V8R 6H5,,3295 NORFOLK,3462000,2206000,1663000,3869000
2023,District of Oak Bay,11-4197-00,V8R 6H5,,3285 NORFOLK,2842000,2140000,868000,3008000
2023,District of Oak Bay,11-4198-00,V8R 3N6,,3275 NORFOLK,2261000,2038000,374000,2412000
2023,District of Oak Bay,11-4198-00,V8S 2G4,,3275 NORFOLK,2261000,2038000,374000,2412000
2023,District of Oak Bay,11-4198-00,V8R 6H5,,3275 NORFOLK,2261000,2038000,374000,2412000
2023,District of Oak Bay,11-4199-00,L5W 1M9,,3255 NORFOLK,2051300,2186000,1217000,3403000
2023,District of Oak Bay,11-4199-00,V8X 3V5,,3255 NORFOLK,2051300,2186000,1217000,3403000
2023,District of Oak Bay,11-4200-00,V8R 6H5,,3245 NORFOLK,2003000,2071000,57600,2128600
2023,District of Oak Bay,11-4201-00,V8R 6H5,,3225 NORFOLK,3297000,2169000,1599000,3768000
2023,District of Oak Bay,11-4202-00,V8R 6H5,,3215 NORFOLK,2331000,2288000,214000,2502000
2023,District of Oak Bay,11-4203-00,V8R 6H5,,3195 NORFOLK,2483000,2182000,457000,2639000
2023,District of Oak Bay,11-4204-00,V8R 6H5,,3185 NORFOLK,2746000,2199000,707000,2906000
2023,District of Oak Bay,11-4205-00,V8R 1Z9,,3175 NORFOLK,2248000,2172000,237000,2409000
2023,District of Oak Bay,11-4207-00,V8R 6H5,,3145 NORFOLK,2326000,2150000,331000,2481000
2023,District of Oak Bay,11-4208-00,V8R 6H5,,3125 NORFOLK,2310000,2172000,297000,2469000
2023,District of Oak Bay,11-4209-00,V8R 6H5,,3115 NORFOLK,2119100,2258000,32600,2290600
2023,District of Oak Bay,11-4210-00,V8R 6H5,,3105 NORFOLK,4108000,2429000,2044000,4473000
2023,District of Oak Bay,11-4211-00,V8R 3R2,,2950 LANSDOWNE,4529000,2461000,2484000,4945000
2023,District of Oak Bay,11-4212-00,V7V 4S4,,2980 LANSDOWNE,2241400,2386000,30100,2416100
2023,District of Oak Bay,11-4213-00,V8R 3R2,,3000 LANSDOWNE,2084800,2199000,41500,2240500
2023,District of Oak Bay,11-4214-00,V8R 6H6,,3110 EXETER,2979000,2675000,459000,3134000
2023,District of Oak Bay,11-4215-00,V8R 6H6,,3130 EXETER,2946000,2629000,513000,3142000
2023,District of Oak Bay,11-4216-00,V8W 0B6,,3160 EXETER,2777000,2688000,281000,2969000
2023,District of Oak Bay,11-4217-00,V8R 6H6,,3170 EXETER,3598000,2535000,1466000,4001000
2023,District of Oak Bay,11-4218-00,V8R 6H6,,3190 EXETER,2686000,2546000,332000,2878000
2023,District of Oak Bay,11-4219-00,V8R 6H6,,3200 EXETER,2841000,2267000,888000,3155000
2023,District of Oak Bay,11-4220-00,V8R 6H6,,3220 EXETER,3409000,2221000,1648000,3869000
2023,District of Oak Bay,11-4221-00,V8N 3V1,,3240 EXETER,1995000,2172000,0,2172000
2023,District of Oak Bay,11-4222-00,V8R 6H6,,3250 EXETER,3278000,2141000,1571000,3712000
2023,District of Oak Bay,11-4223-00,V8R 6H6,,3260 EXETER,3563000,2142000,1738000,3880000
2023,District of Oak Bay,11-4224-00,V8R 6H6,,3280 EXETER,2297000,2165000,274000,2439000
2023,District of Oak Bay,11-4225-00,V8R 6H6,,3290 EXETER,2343000,2198000,301000,2499000
2023,District of Oak Bay,11-4226-00,V8R 6H6,,3300 EXETER,2531000,2277000,442000,2719000
2023,District of Oak Bay,11-4227-00,V8R 6H6,,3320 EXETER,3112000,3078000,262000,3340000
2023,District of Oak Bay,11-4228-00,V8R 6M3,,3340 BEACH,3412000,3519000,159000,3678000
2023,District of Oak Bay,11-4229-00,V8R 6M3,,3360 BEACH,4105000,3367000,989000,4356000
2023,District of Oak Bay,11-4230-00,V8R 6M3,,3380 BEACH,3422000,3104000,542000,3646000
2023,District of Oak Bay,11-4231-00,V8W 2H7,,3390 BEACH,7028000,3175000,4114000,7289000
2023,District of Oak Bay,11-4231-00,V8R 6M3,,3390 BEACH,7028000,3175000,4114000,7289000
2023,District of Oak Bay,11-4231-01,V8R 6H5,,4145 NORFOLK,81200,88400,0,88400
2023,District of Oak Bay,11-4233-00,V8R 6H7,,3295 EXETER,1911300,1977000,53900,2030900
2023,District of Oak Bay,11-4235-00,V8R 6H7,,3275 EXETER,2348000,2156000,317000,2473000
2023,District of Oak Bay,11-4236-00,V8R 6H7,,3245 EXETER,2215000,2167000,202000,2369000
2023,District of Oak Bay,11-4237-00,V8R 6H7,,3235 EXETER,2050800,2145000,48400,2193400
2023,District of Oak Bay,11-4238-00,V8R 6H7,,3225 EXETER,2018000,2130000,45500,2175500
2023,District of Oak Bay,11-4239-00,V8R 6H7,,3205 EXETER,2300000,2130000,318000,2448000
2023,District of Oak Bay,11-4240-00,V8R 6H7,,3195 EXETER,2413000,2269000,313000,2582000
2023,District of Oak Bay,11-4241-00,V8X 3B3,,3175 EXETER,2150000,2305000,1491000,3796000
2023,District of Oak Bay,11-4242-00,V8R 6H7,,3145 EXETER,2655000,2325000,477000,2802000
2023,District of Oak Bay,11-4243-00,V8R 3R4,,3020 LANSDOWNE,2539000,2419000,2966000,5385000
2023,District of Oak Bay,11-4244-00,V8R 3R4,,3050 LANSDOWNE,4477000,2151000,2718000,4869000
2023,District of Oak Bay,11-4245-00,V8R 6L8,,3200 BEACH,2816000,2622000,391000,3013000
2023,District of Oak Bay,11-4246-00,V8R 6L8,,3210 BEACH,3415000,2795000,803000,3598000
2023,District of Oak Bay,11-4247-00,V8R 6L8,,3220 BEACH,4046000,2780000,2077000,4857000
2023,District of Oak Bay,11-4248-00,V8R 6L8,,3230 BEACH,2904000,2801000,317000,3118000
2023,District of Oak Bay,11-4249-00,V8R 6L8,,3240 BEACH,2687400,2841000,47300,2888300
2023,District of Oak Bay,11-4250-00,V8R 6L8,,3250 BEACH,5123000,2822000,2758000,5580000
2023,District of Oak Bay,11-4251-00,,,3260 BEACH,2817000,2840000,191000,3031000
2023,District of Oak Bay,11-4253-00,V8R 6M1,,3280 BEACH,2565200,2729000,34800,2763800
2023,District of Oak Bay,11-4255-00,V8R 6L1,,2985 BEACH,9011000,4783000,4094000,8877000
2023,District of Oak Bay,11-4256-00,V8R 3N5,,3065 SURREY,5368000,4377000,658000,5035000
2023,District of Oak Bay,11-4257-00,V8R 6L1,,2997 BEACH,2535000,2515000,210000,2725000
2023,District of Oak Bay,11-4257-01,V8R 6L1,,2999 BEACH,3727000,3001000,958000,3959000
2023,District of Oak Bay,11-4258-00,V8R 1G2,, BEACH,1401000,1616000,0,1616000
2023,District of Oak Bay,11-4259-00,V8S 4Z1,,1167 ST. DAVID,1584000,1381000,338000,1719000
2023,District of Oak Bay,11-4260-00,V8S 4Z1,,1185 ST. DAVID,1586000,1507000,215000,1722000
2023,District of Oak Bay,11-4261-00,V8S 5B5,,1007 ST. LOUIS,1431000,1289000,238000,1527000
2023,District of Oak Bay,11-4261-00,V8S 5H2,,1007 ST. LOUIS,1431000,1289000,238000,1527000
2023,District of Oak Bay,11-4264-01,V8S 2L6,,131 BEACH,2640000,1408000,1680000,3088000
2023,District of Oak Bay,11-4264-02,V8S 2K8,,85 SYLVAN,1685000,1802000,230000,2032000
2023,District of Oak Bay,11-4266-00,V8S 2L6,,141 BEACH,2183000,2336000,301000,2637000
2023,District of Oak Bay,11-4267-00,V8S 2K8,,73 SYLVAN,2158000,1913000,652000,2565000
2023,District of Oak Bay,11-4268-00,V8M 2H6,,2239 OAK BAY,1759000,1564000,233000,1797000
2023,District of Oak Bay,11-4271-00,V8S 5A9,,668 BYNG,2298000,2288000,466000,2754000
2023,District of Oak Bay,11-4272-00,V8S 5A9,,658 BYNG,1726000,1864000,212000,2076000
2023,District of Oak Bay,11-4274-00,V8R 6L9,,3265 BEACH,10189000,4663000,4758000,9421000
2023,District of Oak Bay,11-4275-00,V8R 6L9,,3245 BEACH,5512000,4641000,419000,5060000
2023,District of Oak Bay,11-4276-00,V8S 4L1,,713 MOUNTJOY,1759000,1849000,255000,2104000
2023,District of Oak Bay,11-4276-00,K2H 8C6,,713 MOUNTJOY,1759000,1849000,255000,2104000
2023,District of Oak Bay,11-4277-00,V8S 4L1,,723 MOUNTJOY,1681000,1795000,225000,2020000
2023,District of Oak Bay,11-4278-00,V8S 4L1,,741 MOUNTJOY,1627000,1795000,169000,1964000
2023,District of Oak Bay,11-4279-00,V8S 4L1,,759 MOUNTJOY,1739000,1795000,283000,2078000
2023,District of Oak Bay,11-4280-00,V8S 4L1,,765 MOUNTJOY,1795000,1794000,336000,2130000
2023,District of Oak Bay,11-4281-00,V8S 4L1,,777 MOUNTJOY,1976000,2065000,311000,2376000
2023,District of Oak Bay,11-4282-00,V8S 2L3,,15 BEACH,1791000,1750000,391000,2141000
2023,District of Oak Bay,11-4283-00,V8S 2T7,,29 BEACH,1617000,1806000,163000,1969000
2023,District of Oak Bay,11-4285-00,V8R 1G2,, MONTEREY,351000,405000,0,405000
2023,District of Oak Bay,11-4286-01,V8R 6J3,,1832 BEACH,2751000,1574000,1508000,3082000
2023,District of Oak Bay,11-4286-02,V8R 6J3,,1820 BEACH,2782000,1589000,1549000,3138000
2023,District of Oak Bay,11-4287-00,V8S 2J5,,165 BARKLEY,251900,293000,9100,302100
2023,District of Oak Bay,11-4288-00,V8S 2J5,,157 BARKLEY,1573000,1736000,160000,1896000
2023,District of Oak Bay,11-4289-00,V8R 6E5,,3295 UPPER TERRACE,5840000,3903000,2436000,6339000
2023,District of Oak Bay,11-4289-00,V8W 2E6,,3295 UPPER TERRACE,5840000,3903000,2436000,6339000
2023,District of Oak Bay,11-4290-00,V8R 6E5,,3325 UPPER TERRACE,4951000,4420000,912000,5332000
2023,District of Oak Bay,11-4291-00,V8R 3T1,,3375 UPPER TERRACE,4136000,4174000,297000,4471000
2023,District of Oak Bay,11-4292-00,M8X 2Z8,,3385 UPPER TERRACE,5499000,4888000,1232000,6120000
2023,District of Oak Bay,11-4293-00,V8R 6E8,,3435 UPPER TERRACE,6998000,4758000,2815000,7573000
2023,District of Oak Bay,11-4293-01,V8S 3E3,,3393 UPPER TERRACE,4520000,4512000,297000,4809000
2023,District of Oak Bay,11-4294-00,V8S 2R2,,2070 CENTRAL,1681000,1529000,289000,1818000
2023,District of Oak Bay,11-4295-00,V8S 2R2,,2080 CENTRAL,1868000,1508000,539000,2047000
2023,District of Oak Bay,11-4296-00,V8S 4L8,,736 FALKLAND,1713000,1406000,455000,1861000
2023,District of Oak Bay,11-4297-00,V8S 4L8,,746 FALKLAND,1644000,1405000,380000,1785000
2023,District of Oak Bay,11-4298-00,V8S 4L8,,756 FALKLAND,1593000,1405000,320000,1725000
2023,District of Oak Bay,11-4299-00,V8S 4L8,,766 FALKLAND,1460000,1405000,165000,1570000
2023,District of Oak Bay,11-4300-00,V8S 4L8,,776 FALKLAND,1485000,1404000,194000,1598000
2023,District of Oak Bay,11-4301-00,V8R 5K8,,3620 CADBORO BAY,3174000,2889000,649000,3538000
2023,District of Oak Bay,11-4303-00,V8S 2L7,,178 BEACH,2056000,1623000,849000,2472000
2023,District of Oak Bay,11-4304-00,V8S 2L7,,182 BEACH,1531000,1623000,206000,1829000
2023,District of Oak Bay,11-4305-00,V8S 2L7,,186 BEACH,1492000,1622000,165000,1787000
2023,District of Oak Bay,11-4306-00,V8S 5B8,,633 RADCLIFFE,3172000,2712000,237000,2949000
2023,District of Oak Bay,11-4307-00,V8S 5B8,,639 RADCLIFFE,4816000,3040000,1828000,4868000
2023,District of Oak Bay,11-4308-00,V8S 5B8,,645 RADCLIFFE,3456000,2887000,392000,3279000
2023,District of Oak Bay,11-4309-00,V8R 1G2,, RADCLIFFE,1946000,2265000,0,2265000
2023,District of Oak Bay,11-4310-00,V8R 1G2,, ,36600,39400,0,39400
2023,District of Oak Bay,11-4310-00,V9T 6J9,, ,36600,39400,0,39400
2023,District of Oak Bay,11-4315-00,V8R 1R7,,2793 SOMASS,4258000,3434000,570000,4004000
2023,District of Oak Bay,11-4316-00,V8R 1R7,,2789 SOMASS,4049000,3065000,833000,3898000
2023,District of Oak Bay,11-4317-00,V8R 1R7,,2783 SOMASS,3415000,3077000,164000,3241000
2023,District of Oak Bay,11-4318-00,V8R 5V5,,1654 MONTEREY,1233000,1210000,133000,1343000
2023,District of Oak Bay,11-4319-00,V8R 1G2,, ST. ANN,289000,337000,0,337000
2023,District of Oak Bay,11-4320-00,V8R 6C5,,2570 NOTTINGHAM,2600000,2124000,842000,2966000
2023,District of Oak Bay,11-4321-00,K7P 0R7,,2560 NOTTINGHAM,2416000,2556000,46700,2602700
2023,District of Oak Bay,11-4322-00,V8S 4Y7,,1057 ST. DAVID,1489000,1381000,210000,1591000
2023,District of Oak Bay,11-4323-00,V8S 4Y7,,1067 ST. DAVID,1808000,1381000,557000,1938000
2023,District of Oak Bay,11-4324-00,V8S 4Y7,,1075 ST. DAVID,1499000,1381000,235000,1616000
2023,District of Oak Bay,11-4325-00,V8S 4Y7,,1091 ST. DAVID,1460000,1315000,477000,1792000
2023,District of Oak Bay,11-4326-00,V8S 5A2,,1092 TRANSIT,1425000,1347000,172000,1519000
2023,District of Oak Bay,11-4327-00,V8S 5A2,,1080 TRANSIT,1515000,1347000,276000,1623000
2023,District of Oak Bay,11-4328-00,V8S 5A2,,1070 TRANSIT,1680000,1347000,476000,1823000
2023,District of Oak Bay,11-4329-00,V8R 5H2,,2016 ESPLANADE,2057000,1969000,212000,2181000
2023,District of Oak Bay,11-4330-00,V6K 3W6,,2032 ESPLANADE,2678000,2024000,909000,2933000
2023,District of Oak Bay,11-4331-00,V8S 3G4,,2051 GRANITE,1228000,1144000,172000,1316000
2023,District of Oak Bay,11-4332-00,V8S 3G4,,2061 GRANITE,1187000,1152000,122000,1274000
2023,District of Oak Bay,11-4333-00,V8S 4P8,,1360 MITCHELL,1204000,1138000,153000,1291000
2023,District of Oak Bay,11-4334-00,V7T 1A7,,2000 OAK BAY,2020000,1233000,831000,2064000
2023,District of Oak Bay,11-4334-00,V4L 2N2,,2000 OAK BAY,2020000,1233000,831000,2064000
2023,District of Oak Bay,11-4334-00,V8L 5E6,,2000 OAK BAY,2020000,1233000,831000,2064000
2023,District of Oak Bay,11-4335-00,V8S 3A4,,2526 MARGATE,1461000,1394000,174000,1568000
2023,District of Oak Bay,11-4336-00,S4V 2A2,,2576 MARGATE,2177000,1437000,1441000,2878000
2023,District of Oak Bay,11-4337-00,V8R 2E8,,2529 BOWKER,1357000,1232000,256000,1488000
2023,District of Oak Bay,11-4338-00,V5V 3L8,,1970 LULIE,1234000,1204000,136000,1340000
2023,District of Oak Bay,11-4339-00,V8R 1H8,,663 RADCLIFFE,4200000,3308000,699000,4007000
2023,District of Oak Bay,11-4340-00,V8S 5B8,,659 RADCLIFFE,3444000,2492000,840000,3332000
2023,District of Oak Bay,11-4341-00,V8R 3K8,,2796 THOMPSON,1761000,1734000,199000,1933000
2023,District of Oak Bay,11-4342-00,V8R 3L5,,2795 DUFFERIN,1676000,1650000,189000,1839000
2023,District of Oak Bay,11-4343-00,V8R 2V4,,2785 DUFFERIN,1747000,1650000,263000,1913000
2023,District of Oak Bay,11-4343-00,V8R 3L5,,2785 DUFFERIN,1747000,1650000,263000,1913000
2023,District of Oak Bay,11-4343-00,V8S 4N3,,2785 DUFFERIN,1747000,1650000,263000,1913000
2023,District of Oak Bay,11-4344-00,V8R 3L5,,2771 DUFFERIN,1705000,1650000,220000,1870000
2023,District of Oak Bay,11-4345-00,V8R 3L5,,2761 DUFFERIN,1627000,1650000,131000,1781000
2023,District of Oak Bay,11-4346-00,V8Y 2K1,,2757 DUFFERIN,1838000,1842000,176000,2018000
2023,District of Oak Bay,11-4347-00,V8R 1R7,,2753 SOMASS,5392000,3245000,1912000,5157000
2023,District of Oak Bay,11-4348-00,V8R 1R7,,2773 SOMASS,6992000,3563000,3314000,6877000
2023,District of Oak Bay,11-4351-00,V8S 4K2,,301 DENISON,1336000,1130000,415000,1545000
2023,District of Oak Bay,11-4352-00,V8S 2K8,,20 SYLVAN,3017000,2652000,895000,3547000
2023,District of Oak Bay,11-4353-00,V8R 1R8,,2810 SOMASS,2559000,2353000,458000,2811000
2023,District of Oak Bay,11-4354-00,V8R 1R8,,2820 SOMASS,2353000,2247000,318000,2565000
2023,District of Oak Bay,11-4355-00,V8R 1R8,,2830 SOMASS,2507000,2331000,408000,2739000
2023,District of Oak Bay,11-4356-00,V8S 2T6,,668 ISLAND,1528000,1726000,139000,1865000
2023,District of Oak Bay,11-4356-00,V8V 3K8,,668 ISLAND,1528000,1726000,139000,1865000
2023,District of Oak Bay,11-4356-10,V8S 2T6,,644 ISLAND,6753000,2488000,4986000,7474000
2023,District of Oak Bay,12-4356-00,V8S 4Z7,,867 TRANSIT,1594000,1482000,220000,1702000
2023,District of Oak Bay,12-4357-00,V8S 4Z7,,879 TRANSIT,1518000,1485000,143000,1628000
2023,District of Oak Bay,12-4358-00,V8S 2T9,,880 ISLAND,1368500,1386000,91700,1477700
2023,District of Oak Bay,12-4359-00,V8S 2T9,,872 ISLAND,1750000,1572000,286000,1858000
2023,District of Oak Bay,12-4362-00,V8R 6J4,,1909 BEACH,1781000,1647000,301000,1948000
2023,District of Oak Bay,12-4363-00,V8R 6J4,,1929 BEACH,1747000,1635000,287000,1922000
2023,District of Oak Bay,12-4364-00,V8R 6J4,,1949 BEACH,1725000,1635000,267000,1902000
2023,District of Oak Bay,12-4365-00,V8R 6J4,,1959 BEACH,1879000,1727000,327000,2054000
2023,District of Oak Bay,12-4366-00,V8R 6M8,,1860 GREATFORD,1875000,1677000,374000,2051000
2023,District of Oak Bay,12-4367-00,V8R 6M8,,1880 GREATFORD,1956000,1713000,447000,2160000
2023,District of Oak Bay,12-4368-00,V6N 1Y2,,1890 GREATFORD,1767000,1768000,189000,1957000
2023,District of Oak Bay,12-4369-00,V8R 6M8,,1908 GREATFORD,3178000,1689000,1925000,3614000
2023,District of Oak Bay,12-4370-00,V8R 6M8,,1920 GREATFORD,1798000,1682000,288000,1970000
2023,District of Oak Bay,12-4371-00,V8R 6M8,,1940 GREATFORD,2066000,1682000,601000,2283000
2023,District of Oak Bay,12-4372-00,V8R 2G4,,2733 BOWKER,1876000,1648000,404000,2052000
2023,District of Oak Bay,12-4373-00,V8R 6N1,,1857 BOWKER,3224000,2092000,1489000,3581000
2023,District of Oak Bay,12-4375-00,V8R 6N1,,1935 BOWKER,2600000,2141000,727000,2868000
2023,District of Oak Bay,12-4376-00,V8R 6N1,,1939 BOWKER,2482000,2174000,577000,2751000
2023,District of Oak Bay,12-4377-00,V8R 6N1,,1965 BOWKER,2702000,2163000,846000,3009000
2023,District of Oak Bay,12-4378-00,V8R 6N2,,1860 BOWKER,3073000,2679000,199000,2878000
2023,District of Oak Bay,12-4379-00,V8R 6N2,, BOWKER,17300,15800,0,15800
2023,District of Oak Bay,12-4380-00,V8R 1G1,,1900 BOWKER,2696000,2313000,166000,2479000
2023,District of Oak Bay,12-4381-00,V8R 6N2,,1920 BOWKER,2857700,2537000,115000,2652000
2023,District of Oak Bay,12-4381-00,V8R 6N2,,1920 BOWKER,2857700,2537000,115000,2652000
2023,District of Oak Bay,12-4382-00,V8R 6N2,,1936 BOWKER,3702000,2603000,987000,3590000
2023,District of Oak Bay,12-4383-00,V8R 6N2,,1938 BOWKER,3220000,2626000,402000,3028000
2023,District of Oak Bay,12-4384-00,V8R 6N2,,1960 BOWKER,3198000,2479000,547000,3026000
2023,District of Oak Bay,12-4385-00,V8R 2G3,,2754 BOWKER,1691000,1672000,179000,1851000
2023,District of Oak Bay,12-4386-00,V8R 2G3,,2764 BOWKER,1758000,1670000,259000,1929000
2023,District of Oak Bay,12-4387-00,V8R 6E6,,3270 UPPER TERRACE,2777000,2369000,679000,3048000
2023,District of Oak Bay,12-4388-00,V8R 6E6,,3290 UPPER TERRACE,2546000,2302000,541000,2843000
2023,District of Oak Bay,12-4390-00,V8R 2W4,,2770 THORPE,4960000,3150000,2399000,5549000
2023,District of Oak Bay,12-4392-00,V8S 4Y8,,853 HAMPSHIRE,1242000,1204000,119000,1323000
2023,District of Oak Bay,12-4393-00,V8S 4S3,,851 HAMPSHIRE,2173000,1191000,1253000,2444000
2023,District of Oak Bay,12-4394-00,V8P 5E3,,849 HAMPSHIRE,1241000,1190000,134000,1324000
2023,District of Oak Bay,12-4395-00,V8S 4V2,,848 MONTEREY,1230000,1144000,162000,1306000
2023,District of Oak Bay,12-4396-00,V8S 4V2,,836 MONTEREY,1189000,1131000,132000,1263000
2023,District of Oak Bay,12-4397-00,V8S 4V2,,834 MONTEREY,1199000,1131000,152000,1283000
2023,District of Oak Bay,12-4399-00,V8S 2V1,,941 ISLAND,2060000,1588000,671000,2259000
2023,District of Oak Bay,12-4400-00,V8R 6M6,,3655 BEACH,4119000,3371000,533000,3904000
2023,District of Oak Bay,12-4403-00,V8S 4M7,,441 VICTORIA,1583000,1293000,403000,1696000
2023,District of Oak Bay,12-4404-00,V8S 2L7,,170 BEACH,1606000,1389000,483000,1872000
2023,District of Oak Bay,12-4405-00,V8S 2L7,,174 BEACH,1288000,1392000,156000,1548000
2023,District of Oak Bay,12-4406-00,V8S 4L9,,895 FALKLAND,1361000,1307000,156000,1463000
2023,District of Oak Bay,12-4407-00,V8S 4L9,,885 FALKLAND,1400000,1307000,196000,1503000
2023,District of Oak Bay,12-4408-00,V8S 4L9,,875 FALKLAND,1352000,1308000,144000,1452000
2023,District of Oak Bay,12-4409-00,V8S 2W5,,2117 PENTLAND,1511000,1475000,140000,1615000
2023,District of Oak Bay,12-4410-00,V8S 2W5,,2123 PENTLAND,2829000,1475000,1600000,3075000
2023,District of Oak Bay,12-4411-00,V8S 2W5,,2129 PENTLAND,1502000,1475000,130000,1605000
2023,District of Oak Bay,12-4412-00,V8S 2W5,,2135 PENTLAND,1569000,1475000,205000,1680000
2023,District of Oak Bay,12-4413-00,V8S 4N3,,898 VICTORIA,1348000,1306000,169000,1475000
2023,District of Oak Bay,12-4414-00,V8S 4N3,,888 VICTORIA,1410000,1306000,213000,1519000
2023,District of Oak Bay,12-4415-00,V8S 4N3,,878 VICTORIA,1337000,1306000,130000,1436000
2023,District of Oak Bay,12-4416-00,V8S 4L7,,687 FALKLAND,1369000,1296000,177000,1473000
2023,District of Oak Bay,12-4417-00,V8S 4L7,,667 FALKLAND,1376000,1299000,183000,1482000
2023,District of Oak Bay,12-4418-00,V8S 4L7,,651 FALKLAND,1434000,1312000,231000,1543000
2023,District of Oak Bay,12-4419-00,T6E 4S1,,2115 CENTRAL,1616000,1546000,175000,1721000
2023,District of Oak Bay,12-4420-00,V8S 2R4,,2125 CENTRAL,1882000,1546000,485000,2031000
2023,District of Oak Bay,12-4421-00,V8S 2R4,,2131 CENTRAL,1611000,1546000,178000,1724000
2023,District of Oak Bay,12-4422-00,V8S 2R4,,2137 CENTRAL,1619000,1546000,198000,1744000
2023,District of Oak Bay,12-4423-00,V8S 4N1,,680 VICTORIA,1403000,1284000,216000,1500000
2023,District of Oak Bay,12-4424-00,V8S 4N1,,666 VICTORIA,1290000,1274000,110000,1384000
2023,District of Oak Bay,12-4425-00,V8S 4N1,,658 VICTORIA,1366000,1264000,192000,1456000
2023,District of Oak Bay,12-4426-00,V8S 2M1,,284 BEACH,2191000,2360000,214000,2574000
2023,District of Oak Bay,12-4426-00,V8S 2M1,,284 BEACH,2191000,2360000,214000,2574000
2023,District of Oak Bay,12-4427-00,V8S 2M1,,290 BEACH,2257000,2050000,593000,2643000
2023,District of Oak Bay,12-4428-00,V8S 2M1,,298 BEACH,2221000,1960000,656000,2616000
2023,District of Oak Bay,12-4429-00,V8S 4T7,,436 MONTEREY,3040000,1742000,1673000,3415000
2023,District of Oak Bay,12-4430-00,V8P 5E1,,3710 CADBORO BAY,2800000,2770000,235000,3005000
2023,District of Oak Bay,12-4431-00,V8S 2L5,,130 BEACH,1525000,1588000,244000,1832000
2023,District of Oak Bay,12-4432-00,V8S 2L5,,140 BEACH,1556000,1604000,268000,1872000
2023,District of Oak Bay,12-4433-00,V8S 2L5,,150 BEACH,1602000,1601000,323000,1924000
2023,District of Oak Bay,12-4434-00,V8S 2L5,,160 BEACH,1869000,1503000,737000,2240000
2023,District of Oak Bay,12-4435-00,V8S 4M6,,420 VICTORIA,1405000,1302000,203000,1505000
2023,District of Oak Bay,12-4436-00,V8S 4M6,,440 VICTORIA,1475000,1295000,297000,1592000
2023,District of Oak Bay,12-4437-00,V8S 4Z7,,829 TRANSIT,1561000,1466000,206000,1672000
2023,District of Oak Bay,12-4438-00,V8S 4Z7,,821 TRANSIT,1590000,1472000,238000,1710000
2023,District of Oak Bay,12-4439-00,V8S 2T9,,836 ISLAND,1693000,1466000,339000,1805000
2023,District of Oak Bay,12-4440-00,V8S 2T9,,828 ISLAND,1579000,1472000,221000,1693000
2023,District of Oak Bay,12-4441-00,V8S 2K8,, SYLVAN,1890000,2300000,0,2300000
2023,District of Oak Bay,12-4442-00,V8S 2K8,,52 SYLVAN,2605000,2872000,273000,3145000
2023,District of Oak Bay,12-4443-00,V8S 2M7,,650 BEACH,1904000,1820000,462000,2282000
2023,District of Oak Bay,12-4444-00,V8S 2M7,,668 BEACH,3309000,3388000,599000,3987000
2023,District of Oak Bay,12-4445-00,V8S 4K9,,726 MOUNTJOY,2650000,2777000,390000,3167000
2023,District of Oak Bay,12-4446-00,V8S 4K9,,706 MOUNTJOY,2606000,2762000,370000,3132000
2023,District of Oak Bay,12-4447-05,V8S 4K9,,686 MOUNTJOY,2946000,3240000,317000,3557000
2023,District of Oak Bay,12-4447-05,V8S 4K9,,686 MOUNTJOY,2946000,3240000,317000,3557000
2023,District of Oak Bay,12-4448-00,V8R 6E5,,3275 UPPER TERRACE,4355000,3689000,680000,4369000
2023,District of Oak Bay,12-4449-00,V8R 6G2,,3200 MIDLAND,3190000,2919000,462000,3381000
2023,District of Oak Bay,12-4451-00,T2X 2M1,,531 MONTEREY,1746000,1716000,161000,1877000
2023,District of Oak Bay,12-4452-00,V8S 4T8,,521 MONTEREY,2658000,1687000,1261000,2948000
2023,District of Oak Bay,12-4453-00,V8R 1Z5,,2313 CRANMORE,1460000,1241000,348000,1589000
2023,District of Oak Bay,12-4454-00,V8R 1Z5,,2321 CRANMORE,1271000,1167000,224000,1391000
2023,District of Oak Bay,12-4455-00,V8R 1Z5,,2331 CRANMORE,1515000,1189000,486000,1675000
2023,District of Oak Bay,12-4456-00,V8S 4Z3,,1454 ST. DAVID,1484000,1410000,176000,1586000
2023,District of Oak Bay,12-4457-00,V8S 4Z3,,1472 ST. DAVID,2098000,1750000,528000,2278000
2023,District of Oak Bay,12-4458-00,V8V 3G7,,1436 ST. DAVID,1334000,1409000,1178000,2587000
2023,District of Oak Bay,12-4459-00,V8S 4Z3,,1416 ST. DAVID,2015000,1712000,493000,2205000
2023,District of Oak Bay,12-4460-00,V8R 1G2,, NEWPORT,84200,97200,0,97200
2023,District of Oak Bay,12-4461-00,V8R 2V7,,2378 PACIFIC,2324000,1879000,695000,2574000
2023,District of Oak Bay,12-4461-00,V8R 3K9,,2378 PACIFIC,2324000,1879000,695000,2574000
2023,District of Oak Bay,12-4463-00,V8R 5K8,,3610 CADBORO BAY,2888000,2787000,317000,3104000
2023,District of Oak Bay,12-4464-00,V8P 4J1,,3614 CADBORO BAY,3032000,2786000,454000,3240000
2023,District of Oak Bay,12-4465-00,V8S 4N4,,847 VICTORIA,1251000,1206000,130000,1336000
2023,District of Oak Bay,12-4466-00,V8S 4N4,,841 VICTORIA,1296000,1204000,188000,1392000
2023,District of Oak Bay,12-4467-00,V8S 2M1,,266 BEACH,2936000,2694000,725000,3419000
2023,District of Oak Bay,12-4468-00,V8S 2M1,,274 BEACH,2570000,2839000,197000,3036000
2023,District of Oak Bay,12-4469-00,V8S 2M5,,586 BEACH,2122000,2322000,163000,2485000
2023,District of Oak Bay,12-4469-00,V9R 6T1,,586 BEACH,2122000,2322000,163000,2485000
2023,District of Oak Bay,12-4471-00,V8P 2R8,,2500 CEDAR HILL CROSS,2025000,1365000,825000,2190000
2023,District of Oak Bay,12-4471-00,V8P 2R8,,2500 CEDAR HILL CROSS,2025000,1365000,825000,2190000
2023,District of Oak Bay,12-4472-00,M4V 2T8,,3602 CADBORO BAY,1661000,1232000,522000,1754000
2023,District of Oak Bay,12-4473-00,V8S 4L9,,855 FALKLAND,1439000,1358000,185000,1543000
2023,District of Oak Bay,12-4474-00,V8S 4L9,,845 FALKLAND,1522000,1359000,286000,1645000
2023,District of Oak Bay,12-4475-00,V8S 4L9,,833 FALKLAND,1372000,1319000,147000,1466000
2023,District of Oak Bay,12-4476-00,V8S 4L9,,825 FALKLAND,1722000,1709000,138000,1847000
2023,District of Oak Bay,12-4477-00,V9H 1N7,,840 VICTORIA,1783000,1707000,232000,1939000
2023,District of Oak Bay,12-4478-00,V8S 4N3,,870 VICTORIA,1493000,1317000,293000,1610000
2023,District of Oak Bay,12-4479-00,V8S 4N3,,860 VICTORIA,2486000,1304000,1512000,2816000
2023,District of Oak Bay,12-4480-00,V8S 4N3,,850 VICTORIA,1424000,1290000,246000,1536000
2023,District of Oak Bay,12-4481-00,V8S 4M6,,548 VICTORIA,1182000,1158000,111000,1269000
2023,District of Oak Bay,12-4482-00,V8S 4M6,,540 VICTORIA,1231000,1159000,164000,1323000
2023,District of Oak Bay,12-4483-00,V8R 6S4,,532 VICTORIA,1365000,1159000,320000,1479000
2023,District of Oak Bay,12-4484-00,V8R 5X9,,2110 MUSGRAVE,1520000,1525000,140000,1665000
2023,District of Oak Bay,12-4485-00,V8R 5V2,,2059 HAMPSHIRE,1515000,1523000,127000,1650000
2023,District of Oak Bay,12-4486-00,V8R 2E6,,2390 BOWKER,1597000,1314000,431000,1745000
2023,District of Oak Bay,12-4486-01,V8R 1G2,, HAMPSHIRE,18200,21000,0,21000
2023,District of Oak Bay,12-4487-00,V8S 5B3,,820 BYNG,1297000,1280000,112000,1392000
2023,District of Oak Bay,12-4488-00,V8S 5B3,,810 BYNG,1320000,1280000,135000,1415000
2023,District of Oak Bay,12-4489-00,V8S 5B3,,790 BYNG,1629000,1578000,168000,1746000
2023,District of Oak Bay,12-4490-00,V8S 2T7,,645 ISLAND,2610000,2338000,694000,3032000
2023,District of Oak Bay,12-4491-00,V8R 5C1,,2771 FOUL BAY,959000,910000,131000,1041000
2023,District of Oak Bay,12-4492-00,V8R 5C1,,2781 FOUL BAY,951000,911000,136000,1047000
2023,District of Oak Bay,12-4493-00,V8R 5C1,,2789 FOUL BAY,972000,910000,146000,1056000
2023,District of Oak Bay,12-4494-00,V8R 2V6,,2371 PACIFIC,1745000,1714000,187000,1901000
2023,District of Oak Bay,12-4495-00,V8R 2V6,,2367 PACIFIC,1829000,1555000,438000,1993000
2023,District of Oak Bay,12-4496-00,V8R 2V6,,2357 PACIFIC,1626000,1458000,315000,1773000
2023,District of Oak Bay,12-4497-00,V8R 2V6,,2343 PACIFIC,1637000,1466000,328000,1794000
2023,District of Oak Bay,12-4498-00,V8R 2V6,,2337 PACIFIC,1517000,1465000,187000,1652000
2023,District of Oak Bay,12-4499-00,T3A 2E3,,2331 PACIFIC,1472000,1465000,141000,1606000
2023,District of Oak Bay,12-4500-00,V8R 2V6,,2325 PACIFIC,1453000,1465000,122000,1587000
2023,District of Oak Bay,12-4503-00,V8R 5X2,,1586 YORK,3887000,3775000,410000,4185000
2023,District of Oak Bay,12-4504-00,V8R 3L1,,2648 THOMPSON,1830000,1621000,387000,2008000
2023,District of Oak Bay,12-4505-00,V8R 3L1,,2632 THOMPSON,1607000,1621000,135000,1756000
2023,District of Oak Bay,12-4506-00,V8R 3L1,,2616 THOMPSON,1627000,1620000,155000,1775000
2023,District of Oak Bay,12-4507-00,T2L 0T2,,2600 THOMPSON,1605000,1617000,136000,1753000
2023,District of Oak Bay,12-4508-00,V8R 3L3,,2568 THOMPSON,1914000,1735000,341000,2076000
2023,District of Oak Bay,12-4509-00,V8R 3L3,,2552 THOMPSON,1743000,1736000,170000,1906000
2023,District of Oak Bay,12-4510-00,V8R 5Y4,,2570 MUSGRAVE,1646000,1586000,211000,1797000
2023,District of Oak Bay,12-4511-00,V8R 5Y4,,2594 MUSGRAVE,1660000,1603000,216000,1819000
2023,District of Oak Bay,12-4512-00,V8R 3L5,,2569 DUFFERIN,1628000,1605000,167000,1772000
2023,District of Oak Bay,12-4513-00,V8R 3L5,,2585 DUFFERIN,1660000,1609000,197000,1806000
2023,District of Oak Bay,12-4514-00,V8R 3L5,,2601 DUFFERIN,1819000,1609000,364000,1973000
2023,District of Oak Bay,12-4515-00,V8R 3L5,,2655 DUFFERIN,1618000,1614000,150000,1764000
2023,District of Oak Bay,12-4516-00,V8R 3L5,,2671 DUFFERIN,1655000,1614000,193000,1807000
2023,District of Oak Bay,12-4517-00,V8R 3L5,,2701 DUFFERIN,1845000,1644000,378000,2022000
2023,District of Oak Bay,12-4518-00,V8R 3P8,,2711 DUFFERIN,1688000,1644000,192000,1836000
2023,District of Oak Bay,12-4519-00,V8R 3L5,,2733 DUFFERIN,1760000,1644000,283000,1927000
2023,District of Oak Bay,12-4520-00,V8N 6H8,,2741 DUFFERIN,1961000,1650000,532000,2182000
2023,District of Oak Bay,12-4520-00,V8R 3L5,,2741 DUFFERIN,1961000,1650000,532000,2182000
2023,District of Oak Bay,12-4521-00,V8R 3L4,,2548 DUFFERIN,1745000,1687000,217000,1904000
2023,District of Oak Bay,12-4522-00,V8R 5Y5,,2646 MUSGRAVE,3227000,1637000,1925000,3562000
2023,District of Oak Bay,12-4523-00,V8R 3L4,,2634 DUFFERIN,1634000,1579000,202000,1781000
2023,District of Oak Bay,12-4524-00,V8R 3L4,,2660 DUFFERIN,1580000,1578000,150000,1728000
2023,District of Oak Bay,12-4525-00,V8R 3L4,,2684 DUFFERIN,1723000,1582000,392000,1974000
2023,District of Oak Bay,12-4526-00,V8R 5Y5,,2658 MUSGRAVE,1669000,1637000,182000,1819000
2023,District of Oak Bay,12-4528-00,V8R 3L8,,2741 BURDICK,1743000,1654000,247000,1901000
2023,District of Oak Bay,12-4529-00,V8R 3L8,,2751 BURDICK,2252000,1649000,1725000,3374000
2023,District of Oak Bay,12-4529-00,V8R 3L8,,2751 BURDICK,2252000,1649000,1725000,3374000
2023,District of Oak Bay,12-4530-00,V8R 3L8,,2761 BURDICK,1706000,1650000,214000,1864000
2023,District of Oak Bay,12-4531-00,V8R 3L8,,2771 BURDICK,1736000,1651000,234000,1885000
2023,District of Oak Bay,12-4532-00,V8R 5Y6,,2710 MUSGRAVE,1760000,1637000,298000,1935000
2023,District of Oak Bay,12-4533-00,V8R 5Y6,,2730 MUSGRAVE,1540000,1504000,185000,1689000
2023,District of Oak Bay,12-4534-00,V8R 3L9,,2624 BURDICK,1597000,1554000,181000,1735000
2023,District of Oak Bay,12-4535-00,V8R 3L9,,2632 BURDICK,1651000,1607000,193000,1800000
2023,District of Oak Bay,12-4536-00,V8R 3L9,,2648 BURDICK,1880000,1607000,453000,2060000
2023,District of Oak Bay,12-4537-00,V8R 3L9,,2700 BURDICK,1667000,1651000,173000,1824000
2023,District of Oak Bay,12-4538-00,V8R 3L9,,2712 BURDICK,1690000,1651000,206000,1857000
2023,District of Oak Bay,12-4539-00,V8R 3L9,,2750 BURDICK,1716000,1578000,295000,1873000
2023,District of Oak Bay,12-4540-00,V8R 3L9,,2760 BURDICK,1868000,1578000,461000,2039000
2023,District of Oak Bay,12-4541-00,V8R 3L9,,2770 BURDICK,1614000,1578000,191000,1769000
2023,District of Oak Bay,12-4542-00,V8R 3M3,,2725 DEWDNEY,1842000,1650000,375000,2025000
2023,District of Oak Bay,12-4543-00,V8R 3M3,,2751 DEWDNEY,1748000,1650000,272000,1922000
2023,District of Oak Bay,12-4544-00,V8R 3M3,,2761 DEWDNEY,1823000,1650000,351000,2001000
2023,District of Oak Bay,12-4545-11,V8P 1C1,,2391 LANSDOWNE,2880000,1189000,1983000,3172000
2023,District of Oak Bay,12-4545-12,V8R 5J9,,3096 CADBORO BAY,1494000,1226000,329000,1555000
2023,District of Oak Bay,12-4545-20,V8R 5J9,,3084 CADBORO BAY,1713000,1341000,461000,1802000
2023,District of Oak Bay,12-4547-00,V8R 5J9,,3072 CADBORO BAY,1706000,1412000,378000,1790000
2023,District of Oak Bay,12-4548-00,V8R 5J9,,3050 CADBORO BAY,1565000,1345000,283000,1628000
2023,District of Oak Bay,12-4549-00,V8N 6M8,,3028 CADBORO BAY,1488000,1344000,211000,1555000
2023,District of Oak Bay,12-4549-00,V8N 6M8,,3028 CADBORO BAY,1488000,1344000,211000,1555000
2023,District of Oak Bay,12-4550-00,V8R 5J9,,3022 CADBORO BAY,1511000,1340000,238000,1578000
2023,District of Oak Bay,12-4551-00,V8R 5J9,,3014 CADBORO BAY,1448000,1336000,177000,1513000
2023,District of Oak Bay,12-4552-00,V8R 5J9,,3008 CADBORO BAY,1601000,1333000,345000,1678000
2023,District of Oak Bay,12-4552-00,V8Y 2K3,,3008 CADBORO BAY,1601000,1333000,345000,1678000
2023,District of Oak Bay,12-4553-00,V8R 5J9,,3002 CADBORO BAY,1999000,1329000,844000,2173000
2023,District of Oak Bay,12-4554-00,V8P 1B4,,2001 LANSDOWNE,1254000,1091000,217000,1308000
2023,District of Oak Bay,12-4555-00,V8R 5E2,,3021 FOUL BAY,1226000,1070000,211000,1281000
2023,District of Oak Bay,12-4556-00,V8R 5E2,,3015 FOUL BAY,1227000,998000,291000,1289000
2023,District of Oak Bay,12-4557-00,V8R 5E2,,3011 FOUL BAY,1153000,1014000,193000,1207000
2023,District of Oak Bay,12-4558-00,V8R 2S8,,3007 FOUL BAY,1116000,1003000,162000,1165000
2023,District of Oak Bay,12-4559-00,V8R 5E2,,3003 FOUL BAY,1519000,999000,623000,1622000
2023,District of Oak Bay,12-4560-00,V8R 5E2,,2989 FOUL BAY,1208000,997000,270000,1267000
2023,District of Oak Bay,12-4561-00,V8R 5E2,,2985 FOUL BAY,1234000,995000,311000,1306000
2023,District of Oak Bay,12-4563-00,V8R 5C7,,2981 FOUL BAY,1105000,991000,162000,1153000
2023,District of Oak Bay,12-4564-00,V8R 5C7,,2977 FOUL BAY,1244000,990000,304000,1294000
2023,District of Oak Bay,12-4565-00,V8R 5C7,,2973 FOUL BAY,1243000,988000,307000,1295000
2023,District of Oak Bay,12-4566-00,V8R 5C7,,2969 FOUL BAY,1098000,985000,153000,1138000
2023,District of Oak Bay,12-4567-00,V8R 5C7,,2965 FOUL BAY,1098000,984000,152000,1136000
2023,District of Oak Bay,12-4568-00,V8R 5C7,,2963 FOUL BAY,1121000,981000,185000,1166000
2023,District of Oak Bay,12-4568-00,V8R 5C7,,2963 FOUL BAY,1121000,981000,185000,1166000
2023,District of Oak Bay,12-4569-00,V8R 5C7,,2957 FOUL BAY,1052000,924000,162000,1086000
2023,District of Oak Bay,12-4570-00,V8R 5C7,,2953 FOUL BAY,1052000,952000,141000,1093000
2023,District of Oak Bay,12-4571-00,V8R 5J6,,2739 CADBORO BAY,1139000,974000,269000,1243000
2023,District of Oak Bay,12-4572-01,V8R 5J6,,2735 CADBORO BAY,1179000,973000,315000,1288000
2023,District of Oak Bay,12-4572-02,V8R 5J6,,2725 CADBORO BAY,1221000,974000,371000,1345000
2023,District of Oak Bay,12-4573-00,V8R 5J6,,2709 CADBORO BAY,1084000,974000,203000,1177000
2023,District of Oak Bay,12-4574-00,V8R 5J6,,2691 CADBORO BAY,1021000,974000,136000,1110000
2023,District of Oak Bay,12-4575-00,V8R 5J6,,2683 CADBORO BAY,1019000,973000,134000,1107000
2023,District of Oak Bay,12-4576-00,V8R 5J6,,2675 CADBORO BAY,1038000,974000,154000,1128000
2023,District of Oak Bay,12-4577-00,V8R 5J6,,2661 CADBORO BAY,1127000,973000,237000,1210000
2023,District of Oak Bay,12-4578-00,V8S 2N2,,1121 BEACH,3611000,3285000,912000,4197000
2023,District of Oak Bay,12-4579-00,V8S 2N2,,1131 BEACH,4855000,4423000,10000,4433000
2023,District of Oak Bay,12-4580-00,V8R 2G8,,2742 CAVENDISH,1674100,1734000,107000,1841000
2023,District of Oak Bay,12-4581-00,V8R 2W1,,2162 ESPLANADE,2947000,2691000,469000,3160000
2023,District of Oak Bay,12-4582-00,V8R 5K9,,3605 CADBORO BAY,2848000,2397000,630000,3027000
2023,District of Oak Bay,12-4583-00,V8R 6M7,,3550 BEACH,3747000,3306000,658000,3964000
2023,District of Oak Bay,12-4584-00,V8Z 1E8,,2477 CADBORO BAY,844000,979000,0,979000
2023,District of Oak Bay,12-4585-00,V8Z 1E8,, TOD,622000,728000,0,728000
2023,District of Oak Bay,12-4586-00,V8Z 1E8,,2465 CADBORO BAY,719000,839000,0,839000
2023,District of Oak Bay,12-4587-00,V8R 1G2,, CADBORO BAY,2862000,3305000,0,3305000
2023,District of Oak Bay,12-4588-00,V8R 6L3,,3005 BEACH,4686000,3650000,737000,4387000
2023,District of Oak Bay,12-4589-00,V8R 6L3,,3023 BEACH,5685000,3038000,2647000,5685000
2023,District of Oak Bay,12-4590-00,V8S 4L6,,569 FALKLAND,1950000,1563000,556000,2119000
2023,District of Oak Bay,12-4591-00,V8R 6B9,,557 FALKLAND,1536000,1325000,320000,1645000
2023,District of Oak Bay,12-4592-00,V8S 4L6,,535 FALKLAND,1474000,1325000,265000,1590000
2023,District of Oak Bay,12-4593-00,V8S 2P3,,2116 HALL,1378000,1325000,161000,1486000
2023,District of Oak Bay,12-4593-01,V8S 2P3,,2124 HALL,1382000,1325000,163000,1488000
2023,District of Oak Bay,12-4594-00,V8R 3L2,,2527 THOMPSON,1604000,1419000,341000,1760000
2023,District of Oak Bay,12-4595-00,V8R 1G2,, THOMPSON,587000,687000,0,687000
2023,District of Oak Bay,12-4596-00,V8R 2S4,,2437 ESTEVAN,1495000,1360000,280000,1640000
2023,District of Oak Bay,12-4597-00,V4X 2A5,,2467 ESTEVAN,1400000,1400000,350000,1750000
2023,District of Oak Bay,12-4597-00,V8R 5Y3,,2467 ESTEVAN,1400000,1400000,350000,1750000
2023,District of Oak Bay,12-4598-00,V8S 4Y5,,1463 ST. PATRICK,2731000,1403000,1696000,3099000
2023,District of Oak Bay,12-4599-00,V8S 4Y5,,1471 ST. PATRICK,2450000,1336000,1393000,2729000
2023,District of Oak Bay,12-4600-00,V8S 4Y5,,1455 ST. PATRICK,1458000,1407000,158000,1565000
2023,District of Oak Bay,12-4601-00,V8S 4Y5,,1449 ST. PATRICK,1409000,1361000,150000,1511000
2023,District of Oak Bay,12-4606-00,V8R 2H9,,2560 DALHOUSIE,1787000,1732000,222000,1954000
2023,District of Oak Bay,12-4607-00,V8R 2H9,,2576 DALHOUSIE,1736000,1729000,173000,1902000
2023,District of Oak Bay,12-4608-00,V8R 2H9,,2586 DALHOUSIE,1748000,1732000,177000,1909000
2023,District of Oak Bay,12-4609-00,V8R 6K1,,2276 BEACH,2273000,1612000,933000,2545000
2023,District of Oak Bay,12-4610-00,V8T 3C1,,2300 BEACH,1944000,1638000,505000,2143000
2023,District of Oak Bay,12-4611-00,V0K 1V0,,2322 BEACH,1674000,1580000,251000,1831000
2023,District of Oak Bay,12-4612-00,,,2344 BEACH,1600000,1556000,197000,1753000
2023,District of Oak Bay,12-4612-00,,,2344 BEACH,1600000,1556000,197000,1753000
2023,District of Oak Bay,12-4612-00,,,2344 BEACH,1600000,1556000,197000,1753000
2023,District of Oak Bay,12-4613-00,V8R 2H5,,2319 DALHOUSIE,1465000,1190000,413000,1603000
2023,District of Oak Bay,12-4614-00,V8R 2H5,,2331 DALHOUSIE,1670000,1579000,236000,1815000
2023,District of Oak Bay,12-4615-00,V8R 2H5,,2353 DALHOUSIE,1555000,1530000,163000,1693000
2023,District of Oak Bay,12-4617-10,V8W 1J2,,2072 HAMPSHIRE,3442000,3766000,1000,3767000
2023,District of Oak Bay,12-4617-20,V8R 5V1,,2345 CADBORO BAY,2312000,1005000,1676000,2681000
2023,District of Oak Bay,12-4618-00,V8S 4V1,,747 MONTEREY,1279000,1238000,136000,1374000
2023,District of Oak Bay,12-4619-00,V8S 4V1,,737 MONTEREY,1543000,1239000,421000,1660000
2023,District of Oak Bay,12-4620-00,V8S 2R9,,2240 CENTRAL,1281000,1239000,136000,1375000
2023,District of Oak Bay,12-4621-00,V8R 6J5,,1960 BEACH,1926000,1723000,391000,2114000
2023,District of Oak Bay,12-4622-00,V8M 2H6,,1944 BEACH,1943000,1777000,344000,2121000
2023,District of Oak Bay,12-4623-00,V8R 2G2,,2663 BOWKER,1592000,1465000,262000,1727000
2023,District of Oak Bay,12-4624-00,V8R 2G2,,2645 BOWKER,2919000,1476000,1883000,3359000
2023,District of Oak Bay,12-4625-00,V8R 2G2,,2635 BOWKER,1545000,1487000,190000,1677000
2023,District of Oak Bay,12-4626-00,V8R 5X6,,1953 MONTEITH,1640000,1498000,279000,1777000
2023,District of Oak Bay,12-4626-00,V8R 5X6,,1953 MONTEITH,1640000,1498000,279000,1777000
2023,District of Oak Bay,12-4627-00,V8R 5N5,,1375 MONTEREY,1334000,1302000,130000,1432000
2023,District of Oak Bay,12-4628-00,V8S 4V9,,1355 MONTEREY,1457000,1301000,249000,1550000
2023,District of Oak Bay,12-4630-00,V8S 4M2,,1008 FALKLAND,1440000,1254000,306000,1560000
2023,District of Oak Bay,12-4630-01,V8S 2X8,,2090 MCNEILL,1584000,1522000,177000,1699000
2023,District of Oak Bay,12-4631-00,V8S 4M2,,1020 FALKLAND,1393000,1321000,173000,1494000
2023,District of Oak Bay,12-4632-00,V8S 4M2,,1014 FALKLAND,1417000,1320000,201000,1521000
2023,District of Oak Bay,12-4635-00,V8R 6E7,,3450 UPPER TERRACE,3176000,2980000,394000,3374000
2023,District of Oak Bay,12-4636-00,V8S 4Z4,,473 TRANSIT,1370000,1482000,169000,1651000
2023,District of Oak Bay,12-4637-00,V8S 4Z4,,417 TRANSIT,2586000,2377000,737000,3114000
2023,District of Oak Bay,12-4638-00,V8S 4V1,,771 MONTEREY,1578000,1480000,215000,1695000
2023,District of Oak Bay,12-4639-00,T3A 3Z5,,765 MONTEREY,1621000,1567000,166000,1733000
2023,District of Oak Bay,12-4640-00,V8S 4V1,,757 MONTEREY,1800000,1444000,496000,1940000
2023,District of Oak Bay,12-4641-00,V8S 2R9,,2250 CENTRAL,1406000,1394000,132000,1526000
2023,District of Oak Bay,12-4642-00,V8S 2R9,,2260 CENTRAL,1473000,1399000,182000,1581000
2023,District of Oak Bay,12-4643-00,V8S 2R9,,2270 CENTRAL,1333000,1308000,124000,1432000
2023,District of Oak Bay,12-4644-00,V8S 4L8,,890 FALKLAND,1308000,1259000,144000,1403000
2023,District of Oak Bay,12-4645-00,V8S 4L8,,888 FALKLAND,1313000,1261000,143000,1404000
2023,District of Oak Bay,12-4646-00,V9B 1A4,,878 FALKLAND,1303000,1261000,137000,1398000
2023,District of Oak Bay,12-4647-00,V8S 4L8,,870 FALKLAND,1308000,1261000,145000,1406000
2023,District of Oak Bay,12-4648-00,V8S 4L8,,860 FALKLAND,1346000,1261000,174000,1435000
2023,District of Oak Bay,12-4650-00,V8S 2V8,,867 RUNNYMEDE,2275000,2069000,362000,2431000
2023,District of Oak Bay,12-4651-00,V8S 4X4,,543 ST. PATRICK,1457000,1401000,163000,1564000
2023,District of Oak Bay,12-4652-00,V8S 4X4,,523 ST. PATRICK,1486000,1401000,189000,1590000
2023,District of Oak Bay,12-4653-00,V8S 4Z5,,550 TRANSIT,2680000,2979000,260000,3239000
2023,District of Oak Bay,12-4654-00,V8S 4Z2,,1387 ST. DAVID,2185000,1759000,615000,2374000
2023,District of Oak Bay,12-4654-01,V8S 4Z2,,1383 ST. DAVID,1791000,1602000,324000,1926000
2023,District of Oak Bay,12-4655-00,V8S 2L6,,151 BEACH,1927000,1955000,372000,2327000
2023,District of Oak Bay,12-4657-00,V8S 2K8,,33 SYLVAN,2008000,2029000,392000,2421000
2023,District of Oak Bay,12-4658-00,V8S 4K2,,247 DENISON,3077000,2755000,922000,3677000
2023,District of Oak Bay,12-4659-00,V8S 2K2,,190 KING GEORGE,2879000,2414000,1053000,3467000
2023,District of Oak Bay,12-4661-00,V8R 3M4,,2642 DEWDNEY,1720000,1630000,232000,1862000
2023,District of Oak Bay,12-4662-00,V8R 3M4,,2666 DEWDNEY,1640000,1514000,282000,1796000
2023,District of Oak Bay,12-4663-00,V8R 3M4,,2684 DEWDNEY,1889000,1811000,261000,2072000
2023,District of Oak Bay,12-4664-00,V8R 3M3,,2701 DEWDNEY,1580000,1513000,221000,1734000
2023,District of Oak Bay,12-4665-00,V8R 3M3,,2713 DEWDNEY,1629000,1559000,222000,1781000
2023,District of Oak Bay,12-4666-00,V8S 2T9,,820 ISLAND,1589000,1516000,188000,1704000
2023,District of Oak Bay,12-4667-00,V8S 2T9,,812 ISLAND,1490500,1516000,74500,1590500
2023,District of Oak Bay,12-4667-00,V8S 5E4,,812 ISLAND,1490500,1516000,74500,1590500
2023,District of Oak Bay,12-4668-00,V8S 4Z7,,815 TRANSIT,4397000,2581000,2094000,4675000
2023,District of Oak Bay,12-4669-00,V8R 3M3,,2665 DEWDNEY,1635000,1563000,209000,1772000
2023,District of Oak Bay,12-4670-00,V8R 3M3,,2655 DEWDNEY,1660000,1563000,241000,1804000
2023,District of Oak Bay,12-4671-00,V8R 3M3,,2645 DEWDNEY,1702000,1602000,246000,1848000
2023,District of Oak Bay,12-4674-00,V8S 2Y7,,2241 MCNEILL,1339000,1173000,265000,1438000
2023,District of Oak Bay,12-4675-00,V8S 2Y7,,2243 MCNEILL,1240000,1178000,154000,1332000
2023,District of Oak Bay,12-4676-00,V8S 4T8,,543 MONTEREY,1897000,1645000,397000,2042000
2023,District of Oak Bay,12-4677-00,V8S 4W3,,542 OLIVER,1711000,1410000,423000,1833000
2023,District of Oak Bay,12-4678-00,V8R 5Y7,,2797 MUSGRAVE,1580000,1518000,208000,1726000
2023,District of Oak Bay,12-4679-00,V8R 5Y7,,2789 MUSGRAVE,1703000,1608000,254000,1862000
2023,District of Oak Bay,12-4680-00,V8R 5Y7,,2781 MUSGRAVE,1553000,1531000,161000,1692000
2023,District of Oak Bay,12-4681-00,V8R 5Y7,,2767 MUSGRAVE,1685000,1532000,299000,1831000
2023,District of Oak Bay,12-4682-00,V8R 5Y7,,2749 MUSGRAVE,1588000,1531000,100000,1631000
2023,District of Oak Bay,12-4683-00,V8R 5Y7,,2735 MUSGRAVE,1640000,1485000,306000,1791000
2023,District of Oak Bay,12-4684-00,V8R 5Y7,,2725 MUSGRAVE,1549000,1485000,200000,1685000
2023,District of Oak Bay,12-4685-00,V8R 5Y7,,2711 MUSGRAVE,1499000,1486000,150000,1636000
2023,District of Oak Bay,12-4686-00,V8R 5Z5,,2708 DUNLEVY,1551000,1531000,162000,1693000
2023,District of Oak Bay,12-4687-00,V8R 5Z5,,2718 DUNLEVY,1649000,1531000,250000,1781000
2023,District of Oak Bay,12-4688-00,V8R 5Z5,,2728 DUNLEVY,1583000,1530000,192000,1722000
2023,District of Oak Bay,12-4689-00,V3L 2T2,,2738 DUNLEVY,1559000,1529000,173000,1702000
2023,District of Oak Bay,12-4689-00,V7C 2X4,,2738 DUNLEVY,1559000,1529000,173000,1702000
2023,District of Oak Bay,12-4690-00,V8R 5Z5,,2748 DUNLEVY,1592000,1529000,211000,1740000
2023,District of Oak Bay,12-4690-00,V8R 5Z5,,2748 DUNLEVY,1592000,1529000,211000,1740000
2023,District of Oak Bay,12-4691-00,V8R 5Z5,,2758 DUNLEVY,1716000,1528000,342000,1870000
2023,District of Oak Bay,12-4692-00,V8R 5Z5,,2768 DUNLEVY,1527000,1486000,191000,1677000
2023,District of Oak Bay,12-4693-00,V8R 5Z4,,2757 DUNLEVY,1501000,1434000,207000,1641000
2023,District of Oak Bay,12-4694-00,V8R 5Z4,,2747 DUNLEVY,1418400,1441000,108000,1549000
2023,District of Oak Bay,12-4695-00,V8R 5Z4,,2737 DUNLEVY,1437000,1441000,127000,1568000
2023,District of Oak Bay,12-4696-00,V8R 5Z4,,2727 DUNLEVY,1445000,1441000,137000,1578000
2023,District of Oak Bay,12-4697-00,V8R 5Z4,,2717 DUNLEVY,1497000,1441000,185000,1626000
2023,District of Oak Bay,12-4698-00,V8R 5Z4,,2707 DUNLEVY,1463000,1441000,156000,1597000
2023,District of Oak Bay,12-4699-00,V8R 6E8,,3565 UPPER TERRACE,3444000,3261000,428000,3689000
2023,District of Oak Bay,12-4700-00,V8R 6E8,,3535 UPPER TERRACE,3209000,2479000,1724000,4203000
2023,District of Oak Bay,12-4701-00,V8S 3C3,,2086 WINDSOR,2415000,1739000,941000,2680000
2023,District of Oak Bay,12-4703-00,V8Z 3P3,,2634 CURRIE,1980700,1950000,25900,1975900
2023,District of Oak Bay,12-4705-00,V8S 2G9,,2049 CRESCENT,3096000,1807000,1527000,3334000
2023,District of Oak Bay,12-4706-00,V8S 4J8,,2066 MARNE,6040000,3629000,2236000,5865000
2023,District of Oak Bay,12-4708-00,V8S 2G9,,2035 CRESCENT,2996000,2597000,193000,2790000
2023,District of Oak Bay,12-4709-00,V8S 2T7,,655 ISLAND,3702000,2530000,2076000,4606000
2023,District of Oak Bay,12-4710-00,V8S 4W1,,1414 MONTEREY,1492000,1366000,237000,1603000
2023,District of Oak Bay,12-4713-00,V8R 3S9,,3145 HUMBER,8929000,4380000,4280000,8660000
2023,District of Oak Bay,12-4714-00,V8R 6L9,,3285 BEACH,8381000,4204000,3865000,8069000
2023,District of Oak Bay,12-4715-00,V8R 6L9,,3275 BEACH,5345000,4218000,723000,4941000
2023,District of Oak Bay,12-4716-00,V8S 2V5,,2019 RUNNYMEDE,797600,775000,62500,837500
2023,District of Oak Bay,12-4717-00,V8R 3C4,,2255 ALLENBY,1240000,1209000,134000,1343000
2023,District of Oak Bay,12-4718-00,V8R 3C4,,2267 ALLENBY,1380000,1209000,298000,1507000
2023,District of Oak Bay,12-4719-00,V8R 3J1,,2258 HARLOW,1289000,1209000,189000,1398000
2023,District of Oak Bay,12-4720-00,V8R 3J1,,2270 HARLOW,1263000,1209000,165000,1374000
2023,District of Oak Bay,12-4721-00,V8R 3H9,,2255 HARLOW,1212000,1167000,149000,1316000
2023,District of Oak Bay,12-4722-00,V8R 3H9,,2265 HARLOW,1323000,1168000,269000,1437000
2023,District of Oak Bay,12-4723-00,V8R 3H9,,2275 HARLOW,1183000,1132000,154000,1286000
2023,District of Oak Bay,12-4724-00,V8R 2V5,,2258 PACIFIC,1501000,1167000,489000,1656000
2023,District of Oak Bay,12-4725-00,V8R 2V5,,2268 PACIFIC,1215000,1167000,153000,1320000
2023,District of Oak Bay,12-4726-00,V8R 2V5,,2278 PACIFIC,1235000,1167000,162000,1329000
2023,District of Oak Bay,12-4727-00,V8R 5J5,,2690 CADBORO BAY,1000000,949000,137000,1086000
2023,District of Oak Bay,12-4728-00,V8R 5J5,,2682 CADBORO BAY,982000,941000,123000,1064000
2023,District of Oak Bay,12-4729-00,V8R 5J5,,2674 CADBORO BAY,1025000,932000,175000,1107000
2023,District of Oak Bay,12-4729-00,V8M 1Y2,,2674 CADBORO BAY,1025000,932000,175000,1107000
2023,District of Oak Bay,12-4730-00,V8R 5J5,,2660 CADBORO BAY,965000,923000,126000,1049000
2023,District of Oak Bay,12-4731-00,V8R 5J5,,2658 CADBORO BAY,1055000,913000,232000,1145000
2023,District of Oak Bay,12-4733-00,V8R 5J4,,2644 CADBORO BAY,1451000,1095000,492000,1587000
2023,District of Oak Bay,12-4734-00,V8R 5J4,,2630 CADBORO BAY,1132000,1010000,221000,1231000
2023,District of Oak Bay,12-4735-00,V8R 5J4,,2616 CADBORO BAY,1155000,1128000,125000,1253000
2023,District of Oak Bay,12-4736-11,V8R 2S3,,2280 ESTEVAN,1191000,737000,609000,1346000
2023,District of Oak Bay,12-4736-12,V8R 2S3,,2290 ESTEVAN,1074000,624000,597000,1221000
2023,District of Oak Bay,12-4737-00,V8R 2S3,,2270 ESTEVAN,1241000,1191000,157000,1348000
2023,District of Oak Bay,12-4739-00,V8R 2S2,,2265 ESTEVAN,1270000,1234000,146000,1380000
2023,District of Oak Bay,12-4740-00,V8R 2S2,,2271 ESTEVAN,1097000,1062000,137000,1199000
2023,District of Oak Bay,12-4741-00,V8R 2S2,,2275 ESTEVAN,963400,1006000,42900,1048900
2023,District of Oak Bay,12-4745-00,V8S 4H9,,939 FOUL BAY,1942000,1774000,320000,2094000
2023,District of Oak Bay,12-4748-00,V8S 4H9,,933 FOUL BAY,1959000,1923000,178000,2101000
2023,District of Oak Bay,12-4749-00,V8S 2J5,,167 BARKLEY,2228000,1869000,805000,2674000
2023,District of Oak Bay,12-4750-00,V8S 2L7,,192 BEACH,1664000,1716000,258000,1974000
2023,District of Oak Bay,12-4750-00,V8S 2L7,,192 BEACH,1664000,1716000,258000,1974000
2023,District of Oak Bay,12-4751-00,V8S 2L7,,196 BEACH,1742000,1716000,366000,2082000
2023,District of Oak Bay,12-4752-00,V8S 2L7,,198 BEACH,1676000,1716000,292000,2008000
2023,District of Oak Bay,12-4753-00,V8S 2M1,,242 BEACH,2574000,2132000,841000,2973000
2023,District of Oak Bay,12-4754-00,V8S 2M1,,218 BEACH,1810000,1782000,313000,2095000
2023,District of Oak Bay,12-4755-00,V8R 6B3,,3035 UPLANDS,2347200,2461000,43500,2504500
2023,District of Oak Bay,12-4756-00,V8R 6B3,,3045 UPLANDS,3049000,2629000,627000,3256000
2023,District of Oak Bay,12-4760-00,V8S 2H1,,1912 CRESCENT,2359000,1967000,2213000,4180000
2023,District of Oak Bay,12-4761-00,V8S 2H1,,1920 CRESCENT,1913000,1855000,1330000,3185000
2023,District of Oak Bay,13-4757-00,V8S 3A4,,2538 MARGATE,1432400,1442000,97500,1539500
2023,District of Oak Bay,13-4758-00,V8S 3A4,,2558 MARGATE,1759000,1391000,525000,1916000
2023,District of Oak Bay,13-4760-00,V8S 3A9,,2559 ORCHARD,1965000,1545000,582000,2127000
2023,District of Oak Bay,13-4761-00,V8S 4T8,,619 MONTEREY,1807000,1686000,252000,1938000
2023,District of Oak Bay,13-4762-00,V8S 4T8,,611 MONTEREY,1756000,1698000,185000,1883000
2023,District of Oak Bay,13-4763-00,V8S 4T8,,595 MONTEREY,1897000,1698000,335000,2033000
2023,District of Oak Bay,13-4764-00,T5R 2Y3,,573 MONTEREY,1746000,1698000,172000,1870000
2023,District of Oak Bay,13-4765-00,V8M 1T6,,567 MONTEREY,1806000,1698000,234000,1932000
2023,District of Oak Bay,13-4766-00,V8S 4T8,,555 MONTEREY,1765000,1696000,190000,1886000
2023,District of Oak Bay,13-4767-00,V8R 5T7,,1681 HAMPSHIRE,1378000,1255000,249000,1504000
2023,District of Oak Bay,13-4768-00,V8R 5T7,,1675 HAMPSHIRE,1170000,1204000,71100,1275100
2023,District of Oak Bay,13-4770-00,V8R 5T4,,1647 HAMPSHIRE,2006000,1392000,805000,2197000
2023,District of Oak Bay,13-4771-00,V8R 5V5,,1660 MONTEREY,2306000,1265000,1334000,2599000
2023,District of Oak Bay,13-4773-00,V8S 2J8,,289 KING GEORGE,3546500,3208000,105000,3313000
2023,District of Oak Bay,13-4774-00,V8S 2J8,,291 KING GEORGE,4482400,4075000,118000,4193000
2023,District of Oak Bay,13-4775-00,V8S 4X1,,1355 OLIVER,1656000,1464000,322000,1786000
2023,District of Oak Bay,13-4776-00,V8S 4Y4,,1356 ST. PATRICK,1476000,1464000,123000,1587000
2023,District of Oak Bay,13-4777-00,V8S 4X1,,1345 OLIVER,1909000,1390000,720000,2110000
2023,District of Oak Bay,13-4778-00,V8S 4Y4,,1352 ST. PATRICK,2051000,1688000,535000,2223000
2023,District of Oak Bay,13-4779-00,V8S 4H9,,945 FOUL BAY,1426000,1391000,137000,1528000
2023,District of Oak Bay,13-4780-00,V8S 4H9,,943 FOUL BAY,1524000,1477000,155000,1632000
2023,District of Oak Bay,13-4781-00,V8S 4H9,,941 FOUL BAY,1689000,1507000,278000,1785000
2023,District of Oak Bay,13-4782-01,V8S 4P7,,1204 HEWLETT,2410000,1235000,1443000,2678000
2023,District of Oak Bay,13-4782-02,M6J 3W8,,1198 HEWLETT,2493000,1296000,1464000,2760000
2023,District of Oak Bay,13-4783-00,V8S 4X4,,625 ST. PATRICK,1639000,1520000,240000,1760000
2023,District of Oak Bay,13-4784-00,V8S 4X3,,619 ST. PATRICK,1521000,1519000,110000,1629000
2023,District of Oak Bay,13-4785-00,V8S 5C4,,927 LINKLEAS,1875000,1700000,320000,2020000
2023,District of Oak Bay,13-4788-00,V8P 1B4,,2025 LANSDOWNE,1653000,1380000,347000,1727000
2023,District of Oak Bay,13-4789-00,V8P 1B4,,2049 LANSDOWNE,1676000,1388000,373000,1761000
2023,District of Oak Bay,13-4790-00,V8P 1B4,,2075 LANSDOWNE,2224000,1521000,880000,2401000
2023,District of Oak Bay,13-4791-00,V8P 1B4,,2099 LANSDOWNE,2479000,1702000,941000,2643000
2023,District of Oak Bay,13-4792-00,V8R 5G2,,3034 WESTDOWNE,1852000,1575000,358000,1933000
2023,District of Oak Bay,13-4793-00,V8R 3J6,,2024 MID-DOWNE,2125000,1703000,521000,2224000
2023,District of Oak Bay,13-4794-00,V8R 5G2,,3050 WESTDOWNE,1399000,1244000,224000,1468000
2023,District of Oak Bay,13-4795-00,V8R 5G2,,3042 WESTDOWNE,1369000,1289000,227000,1516000
2023,District of Oak Bay,13-4795-00,V6R 1S8,,3042 WESTDOWNE,1369000,1289000,227000,1516000
2023,District of Oak Bay,13-4796-00,V8R 5G2,,3026 WESTDOWNE,1577000,1234000,429000,1663000
2023,District of Oak Bay,13-4797-00,V8R 5G2,,3018 WESTDOWNE,1409000,1174000,310000,1484000
2023,District of Oak Bay,13-4798-00,V8R 5G2,,3010 WESTDOWNE,1334000,1174000,227000,1401000
2023,District of Oak Bay,13-4799-00,V8R 5G2,,3002 WESTDOWNE,1393000,1224000,224000,1448000
2023,District of Oak Bay,13-4800-00,V8S 2M3,,2994 WESTDOWNE,1417000,1233000,237000,1470000
2023,District of Oak Bay,13-4801-00,V8R 5E9,,2986 WESTDOWNE,1469000,1269000,258000,1527000
2023,District of Oak Bay,13-4802-00,V8R 5E9,,2978 WESTDOWNE,1333000,1232000,147000,1379000
2023,District of Oak Bay,13-4803-00,V8R 5E9,,2970 WESTDOWNE,1294000,1181000,161000,1342000
2023,District of Oak Bay,13-4804-00,V8R 5E9,,2962 WESTDOWNE,1748000,1120000,747000,1867000
2023,District of Oak Bay,13-4805-00,V8R 5E9,,2954 WESTDOWNE,1224000,1110000,162000,1272000
2023,District of Oak Bay,13-4806-00,V8R 5E9,,2946 WESTDOWNE,1201000,1101000,148000,1249000
2023,District of Oak Bay,13-4807-00,V8R 5E9,,2938 WESTDOWNE,1433000,1245000,236000,1481000
2023,District of Oak Bay,13-4808-00,V8R 5C7,,2943 FOUL BAY,996000,891000,146000,1037000
2023,District of Oak Bay,13-4809-00,V8R 5E9,,2930 WESTDOWNE,1460000,1331000,178000,1509000
2023,District of Oak Bay,13-4810-00,V8R 5G1,,2931 WESTDOWNE,1504000,1369000,191000,1560000
2023,District of Oak Bay,13-4811-00,V8R 5G1,,2939 WESTDOWNE,1747000,1364000,467000,1831000
2023,District of Oak Bay,13-4811-00,V8R 5G1,,2939 WESTDOWNE,1747000,1364000,467000,1831000
2023,District of Oak Bay,13-4812-00,V8Y 3E5,,2947 WESTDOWNE,1187000,1087000,148000,1235000
2023,District of Oak Bay,13-4812-00,V8Y 3E5,,2947 WESTDOWNE,1187000,1087000,148000,1235000
2023,District of Oak Bay,13-4813-00,V8R 5G1,,2955 WESTDOWNE,1238000,1104000,193000,1297000
2023,District of Oak Bay,13-4814-00,V8R 5G1,,2963 WESTDOWNE,1262000,1103000,220000,1323000
2023,District of Oak Bay,13-4815-00,V8R 5G1,,2971 WESTDOWNE,1221000,1104000,167000,1271000
2023,District of Oak Bay,13-4816-00,V8R 5G1,,2979 WESTDOWNE,1326000,1153000,228000,1381000
2023,District of Oak Bay,13-4817-00,V8R 5G1,,2987 WESTDOWNE,1345000,1165000,232000,1397000
2023,District of Oak Bay,13-4818-00,V8R 5G1,,2995 WESTDOWNE,1287000,1168000,180000,1348000
2023,District of Oak Bay,13-4819-00,V8N 1K7,,3007 WESTDOWNE,1290000,1143000,203000,1346000
2023,District of Oak Bay,13-4820-00,V8R 5G3,,3015 WESTDOWNE,1526000,1165000,432000,1597000
2023,District of Oak Bay,13-4821-00,V8R 5G3,,3023 WESTDOWNE,1615000,1165000,564000,1729000
2023,District of Oak Bay,13-4822-00,V8R 5G3,,3031 WESTDOWNE,1371000,1223000,212000,1435000
2023,District of Oak Bay,13-4823-00,V8R 5G3,,3041 WESTDOWNE,1394000,1224000,237000,1461000
2023,District of Oak Bay,13-4824-00,V8R 5G3,,3051 WESTDOWNE,1872000,1677000,295000,1972000
2023,District of Oak Bay,13-4825-00,V8P 1B5,,2125 LANSDOWNE,1744000,1554000,274000,1828000
2023,District of Oak Bay,13-4826-00,V8P 1B5,,2149 LANSDOWNE,1795000,1520000,367000,1887000
2023,District of Oak Bay,13-4827-00,V8P 1B5,,2175 LANSDOWNE,1743000,1520000,292000,1812000
2023,District of Oak Bay,13-4828-00,V8X 2B8,,2199 LANSDOWNE,1775000,1548000,318000,1866000
2023,District of Oak Bay,13-4829-00,V8S 2J9,,110 KING GEORGE,1807000,2044000,136000,2180000
2023,District of Oak Bay,13-4833-00,V8R 6A1,,2735 HERON,1827000,1822000,173000,1995000
2023,District of Oak Bay,13-4834-00,V8R 6A1,,2705 HERON,2186000,1623000,834000,2457000
2023,District of Oak Bay,13-4835-00,V8R 5Z9,,2677 HERON,1739000,1656000,232000,1888000
2023,District of Oak Bay,13-4836-00,V8R 5Z9,,2649 HERON,1702000,1584000,261000,1845000
2023,District of Oak Bay,13-4837-00,V8R 5Z8,,2678 HERON,1529000,1490000,182000,1672000
2023,District of Oak Bay,13-4838-00,V8R 5Z8,,2664 HERON,1547000,1490000,205000,1695000
2023,District of Oak Bay,13-4839-00,V8R 5Z8,,2640 HERON,1534000,1490000,185000,1675000
2023,District of Oak Bay,13-4840-00,V8R 5Z8,,2630 HERON,1500000,1490000,150000,1640000
2023,District of Oak Bay,13-4841-00,V8R 5Z8,,2608 HERON,1554000,1490000,210000,1700000
2023,District of Oak Bay,13-4842-00,V8R 5J9,,2998 CADBORO BAY,1469000,1338000,200000,1538000
2023,District of Oak Bay,13-4843-00,V8R 5J9,,2878 CADBORO BAY,1485000,1040000,627000,1667000
2023,District of Oak Bay,13-4844-00,V8R 5J9,,2874 CADBORO BAY,1110000,1046000,190000,1236000
2023,District of Oak Bay,13-4845-00,V8R 2G9,,2131 FAIR,1419000,1432000,105000,1537000
2023,District of Oak Bay,13-4846-02,V8R 2G9,,2121 FAIR,1836000,1093000,953000,2046000
2023,District of Oak Bay,13-4846-03,V8R 2G9,,2127 FAIR,1787000,1090000,885000,1975000
2023,District of Oak Bay,13-4846-04,V8R 2G9,,2125 FAIR,1777000,1074000,937000,2011000
2023,District of Oak Bay,13-4846-05,V8R 2G9,,2123 FAIR,1734000,1074000,884000,1958000
2023,District of Oak Bay,13-4848-00,V8N 1B8,,2150 CADBORO BAY,5278000,3801000,2011000,5812000
2023,District of Oak Bay,13-4848-00,V8Y 3H1,,2150 CADBORO BAY,5278000,3801000,2011000,5812000
2023,District of Oak Bay,13-4852-00,V8W 9T5,, SATELLITE,23800,23800,0,23800
2023,District of Oak Bay,13-4852-05,V4X 1C7,,1175 BEACH,9052000,6369000,2817000,9186000
2023,District of Oak Bay,13-4854-00,V8R 3T1,,3140 HUMBER,5234000,4646000,298000,4944000
2023,District of Oak Bay,13-4855-00,V8R 3T1,,3120 HUMBER,9319000,4523000,4638000,9161000
2023,District of Oak Bay,13-4856-00,V8R 6M2,,3295 BEACH,7362000,4426000,2617000,7043000
2023,District of Oak Bay,13-4857-00,V8S 4H9,,931 FOUL BAY,2862000,2345000,878000,3223000
2023,District of Oak Bay,13-4859-00,V8S 4M5,,2088 FALKLAND,1842000,1514000,497000,2011000
2023,District of Oak Bay,13-4860-00,V8S 3A1,,2102 SUTHERLAND,1816000,1443000,544000,1987000
2023,District of Oak Bay,13-4861-00,V8S 2P4,,2125 HALL,1705000,1504000,343000,1847000
2023,District of Oak Bay,13-4862-00,V8S 2H2,,2008 CRESCENT,1587000,1303000,419000,1722000
2023,District of Oak Bay,13-4863-00,V8S 2H2,,2010 CRESCENT,1467000,1328000,234000,1562000
2023,District of Oak Bay,13-4864-00,V8S 2H2,,2014 CRESCENT,1483000,1307000,274000,1581000
2023,District of Oak Bay,13-4865-00,V8S 2H9,,2055 LORNE,1660000,1310000,509000,1819000
2023,District of Oak Bay,13-4866-00,V8S 2H2,,2048 CRESCENT,1204000,1290000,0,1290000
2023,District of Oak Bay,13-4867-00,V8S 2H9,,2067 LORNE,1353000,1290000,161000,1451000
2023,District of Oak Bay,13-4868-00,V8R 6J3,,1880 BEACH,1745000,1729000,180000,1909000
2023,District of Oak Bay,13-4870-00,V8V 3K5,,2651 ANSCOMB,1785000,1720000,162000,1882000
2023,District of Oak Bay,13-4871-00,V8R 6K1,,2246 BEACH,1752000,1760000,156000,1916000
2023,District of Oak Bay,13-4872-00,V8R 6A3,,2295 LINCOLN,2017000,1807000,402000,2209000
2023,District of Oak Bay,13-4873-00,V8R 6A3,,2279 LINCOLN,1499000,1550000,93300,1643300
2023,District of Oak Bay,13-4874-00,V8R 6A3,,2265 LINCOLN,1608000,1569000,188000,1757000
2023,District of Oak Bay,13-4875-00,V8R 6A3,,2243 LINCOLN,1653000,1581000,218000,1799000
2023,District of Oak Bay,13-4876-00,V8R 6A3,,2227 LINCOLN,1622000,1593000,171000,1764000
2023,District of Oak Bay,13-4877-00,V4A 6P5,,2209 LINCOLN,1553000,1547000,145000,1692000
2023,District of Oak Bay,13-4878-00,V8R 5Z6,,2312 HERON,1969000,1963000,190000,2153000
2023,District of Oak Bay,13-4879-00,V8R 5Z1,,2275 DUNLEVY,2857000,1632000,1602000,3234000
2023,District of Oak Bay,13-4882-00,V8R 5Z6,,2320 HERON,2722000,1732000,1377000,3109000
2023,District of Oak Bay,13-4884-00,V8R 6A4,,2236 LINCOLN,1624000,1621000,154000,1775000
2023,District of Oak Bay,13-4885-00,V8R 6A4,,2326 LINCOLN,1982000,1621000,557000,2178000
2023,District of Oak Bay,13-4886-00,V8R 6A4,,2340 LINCOLN,1686000,1631000,212000,1843000
2023,District of Oak Bay,13-4887-01,V8R 6A4,,2382 LINCOLN,1864000,1572000,461000,2033000
2023,District of Oak Bay,13-4887-02,V8R 6A4,,2356 LINCOLN,1864000,1608000,448000,2056000
2023,District of Oak Bay,13-4888-00,V8R 6A3,,2355 LINCOLN,1506000,1499000,149000,1648000
2023,District of Oak Bay,13-4889-00,V8R 6A3,,2339 LINCOLN,1530000,1525000,146000,1671000
2023,District of Oak Bay,13-4889-00,V8T 3X1,,2339 LINCOLN,1530000,1525000,146000,1671000
2023,District of Oak Bay,13-4890-00,V8R 6A3,,2325 LINCOLN,1526000,1509000,162000,1671000
2023,District of Oak Bay,13-4891-00,V8R 6A3,,2305 LINCOLN,1540000,1530000,152000,1682000
2023,District of Oak Bay,13-4896-00,V8R 1G2,, DENISON,2305000,2654000,0,2654000
2023,District of Oak Bay,13-4898-00,V8R 5M5,,3058 HENDERSON,1600000,1382000,299000,1681000
2023,District of Oak Bay,13-4899-00,V8R 5M5,,3050 HENDERSON,1412000,1235000,250000,1485000
2023,District of Oak Bay,13-4899-00,V8R 5M5,,3050 HENDERSON,1412000,1235000,250000,1485000
2023,District of Oak Bay,13-4900-00,V8R 5M5,,3042 HENDERSON,1375000,1176000,269000,1445000
2023,District of Oak Bay,13-4901-00,V8R 5M5,,3034 HENDERSON,1331000,1177000,208000,1385000
2023,District of Oak Bay,13-4902-00,V8R 5M5,,3026 HENDERSON,1461000,1176000,360000,1536000
2023,District of Oak Bay,13-4903-00,V8R 5M5,,3016 HENDERSON,1396000,1177000,329000,1506000
2023,District of Oak Bay,13-4904-00,V8R 3J8,,2164 MID-DOWNE,2458000,1179000,1541000,2720000
2023,District of Oak Bay,13-4905-00,V8R 3J7,,2163 MID-DOWNE,1368000,1149000,289000,1438000
2023,District of Oak Bay,13-4906-00,V8R 5M3,,2984 HENDERSON,1398000,1176000,290000,1466000
2023,District of Oak Bay,13-4907-00,V8R 5M3,,2976 HENDERSON,1361000,1176000,238000,1414000
2023,District of Oak Bay,13-4908-00,V8R 5M3,,2968 HENDERSON,1295000,1177000,165000,1342000
2023,District of Oak Bay,13-4909-00,V8R 5M3,,2960 HENDERSON,1235000,1103000,184000,1287000
2023,District of Oak Bay,13-4910-00,V8R 5M3,,2952 HENDERSON,1306000,1103000,255000,1358000
2023,District of Oak Bay,13-4911-00,V8R 5M3,,2944 HENDERSON,1243000,1100000,193000,1293000
2023,District of Oak Bay,13-4912-00,V8R 5M3,,2936 HENDERSON,1232000,1107000,168000,1275000
2023,District of Oak Bay,13-4913-00,V8R 5M3,,2932 HENDERSON,1295000,1198000,142000,1340000
2023,District of Oak Bay,13-4914-00,V8X 5J2,,2927 HENDERSON,1414000,1143000,345000,1488000
2023,District of Oak Bay,13-4915-00,V8R 5M4,,2935 HENDERSON,1208000,1109000,146000,1255000
2023,District of Oak Bay,13-4916-00,V8R 5M4,,2943 HENDERSON,1360000,1107000,322000,1429000
2023,District of Oak Bay,13-4917-00,V8R 5M4,,2951 HENDERSON,1254000,1106000,197000,1303000
2023,District of Oak Bay,13-4918-00,V8R 5M4,,2959 HENDERSON,1267000,1109000,210000,1319000
2023,District of Oak Bay,13-4919-00,V8R 5M4,,2967 HENDERSON,1213000,1104000,158000,1262000
2023,District of Oak Bay,13-4920-00,V8R 5M4,,2975 HENDERSON,1249000,1104000,196000,1300000
2023,District of Oak Bay,13-4921-00,V8R 5M4,,2983 HENDERSON,1271000,1104000,216000,1320000
2023,District of Oak Bay,13-4922-00,V8R 5M4,,2991 HENDERSON,1352000,1109000,290000,1399000
2023,District of Oak Bay,13-4923-00,V9A 2Z8,,2220 MID-DOWNE,1323000,1168000,220000,1388000
2023,District of Oak Bay,13-4924-00,V8R 5M6,,3017 HENDERSON,1335000,1164000,233000,1397000
2023,District of Oak Bay,13-4925-00,V8R 5M6,,3027 HENDERSON,1264000,1164000,152000,1316000
2023,District of Oak Bay,13-4925-01,V8R 5M6,,3035 HENDERSON,1336000,1163000,223000,1386000
2023,District of Oak Bay,13-4926-00,V8R 5M6,,3045 HENDERSON,1472000,1222000,328000,1550000
2023,District of Oak Bay,13-4927-00,V8R 5M6,,3053 HENDERSON,1695000,1221000,560000,1781000
2023,District of Oak Bay,13-4928-00,V8R 5M6,,3061 HENDERSON,1421000,1234000,255000,1489000
2023,District of Oak Bay,13-4929-00,V8R 5M6,,3069 HENDERSON,1863000,1518000,441000,1959000
2023,District of Oak Bay,13-4930-00,V8P 1B7,,2225 LANSDOWNE,2268000,1592000,860000,2452000
2023,District of Oak Bay,13-4931-00,V8P 1B7,,2249 LANSDOWNE,1734000,1521000,294000,1815000
2023,District of Oak Bay,13-4932-00,V8P 1B7,,2275 LANSDOWNE,2078000,1554000,650000,2204000
2023,District of Oak Bay,13-4934-00,V8N 3W3,,2029 NEIL,1125000,1093000,129000,1222000
2023,District of Oak Bay,13-4935-00,V8R 3E1,,2035 NEIL,2323000,1145000,1494000,2639000
2023,District of Oak Bay,13-4936-00,V8R 3E1,,2041 NEIL,1194000,1173000,126000,1299000
2023,District of Oak Bay,13-4937-00,V8R 3E1,,2047 NEIL,1249000,1150000,196000,1346000
2023,District of Oak Bay,13-4938-00,V8R 3E1,,2057 NEIL,1224000,1160000,164000,1324000
2023,District of Oak Bay,13-4939-01,V8R 3E1,,2065 NEIL,2337000,1144000,1524000,2668000
2023,District of Oak Bay,13-4939-02,V8R 3E1,,2075 NEIL,2296000,1160000,1495000,2655000
2023,District of Oak Bay,13-4941-00,V8R 3E1,,2083 NEIL,1248000,1157000,201000,1358000
2023,District of Oak Bay,13-4942-00,V8R 3E1,,2091 NEIL,1201000,1144000,156000,1300000
2023,District of Oak Bay,13-4944-00,V8S 4H9,,951 FOUL BAY,1298000,1201000,195000,1396000
2023,District of Oak Bay,13-4945-00,V8S 4H9,,965 FOUL BAY,1182000,1131000,136000,1267000
2023,District of Oak Bay,13-4948-00,V8S 2E5,,2051 BRIGHTON,1970000,1434000,727000,2161000
2023,District of Oak Bay,13-4949-00,V8S 2G5,,185 BARKLEY,1651000,1710000,271000,1981000
2023,District of Oak Bay,13-4950-00,V8S 2J5,,175 BARKLEY,2360000,2290000,555000,2845000
2023,District of Oak Bay,13-4950-01,V8R 1G2,, KING GEORGE,449000,481000,0,481000
2023,District of Oak Bay,13-4951-00,V8R 1G2,, BEACH,32636000,32690000,0,32690000
2023,District of Oak Bay,13-4952-00,V8S 5C4,,957 LINKLEAS,1602000,1395000,342000,1737000
2023,District of Oak Bay,13-4953-00,V8S 5C4,,953 LINKLEAS,1528000,1395000,233000,1628000
2023,District of Oak Bay,13-4957-00,V8R 1G1,,1420 HAMPSHIRE,2149000,2124000,109000,2233000
2023,District of Oak Bay,13-4958-00,V8S 2J2,,24 MAQUINNA,2064000,1803000,439000,2242000
2023,District of Oak Bay,13-4958-10,V8R 1G2,, MAQUINNA,113000,131000,0,131000
2023,District of Oak Bay,13-4961-00,V8V 4Z9,,3555 BEACH,7953000,3225000,3903000,7128000
2023,District of Oak Bay,13-4962-00,V8T 0C7,,2328 DUNLEVY,2936000,1528000,1761000,3289000
2023,District of Oak Bay,13-4963-00,V8R 5Y9,,2346 DUNLEVY,1533000,1467000,206000,1673000
2023,District of Oak Bay,13-4964-00,V8R 5Y9,,2364 DUNLEVY,1537000,1528000,157000,1685000
2023,District of Oak Bay,13-4965-00,V8R 5Y9,,2382 DUNLEVY,1599000,1528000,214000,1742000
2023,District of Oak Bay,13-4966-00,V8R 5Y9,,2400 DUNLEVY,1566000,1528000,184000,1712000
2023,District of Oak Bay,13-4967-00,V8R 5Y9,,2418 DUNLEVY,1563000,1528000,183000,1711000
2023,District of Oak Bay,13-4968-00,V8R 5Y9,,2438 DUNLEVY,1804000,1545000,433000,1978000
2023,District of Oak Bay,13-4969-00,V8R 5Z3,,2607 DUNLEVY,1647000,1490000,297000,1787000
2023,District of Oak Bay,13-4970-00,V8R 5Z3,,2627 DUNLEVY,1589000,1490000,236000,1726000
2023,District of Oak Bay,13-4971-00,V8R 3N1,,2647 DUNLEVY,1506000,1490000,156000,1646000
2023,District of Oak Bay,13-4972-00,V8R 3J1,,2667 DUNLEVY,1512000,1490000,164000,1654000
2023,District of Oak Bay,13-4973-00,V8R 5Z3,,2677 DUNLEVY,1665000,1491000,331000,1822000
2023,District of Oak Bay,13-4974-00,V8V 3P6,,1250 NEWPORT,2732600,2681000,323000,3004000
2023,District of Oak Bay,13-4974-00,V8V 3P6,,1250 NEWPORT,2732600,2681000,323000,3004000
2023,District of Oak Bay,13-4974-00,V8V 3P6,,1250 NEWPORT,2732600,2681000,323000,3004000
2023,District of Oak Bay,13-4974-00,V8V 3P6,,1250 NEWPORT,2732600,2681000,323000,3004000
2023,District of Oak Bay,13-4976-00,V7X 1L3,,1240 NEWPORT,5600000,2853000,3306000,6159000
2023,District of Oak Bay,13-4979-00,V8P 4G8,,2530 WINDSOR,2207000,2055000,376000,2431000
2023,District of Oak Bay,13-4980-00,V8S 5A6,,1255 ST. DENIS,1575000,1351000,335000,1686000
2023,District of Oak Bay,13-4981-00,V8S 5A6,,1257 ST. DENIS,1402000,1312000,201000,1513000
2023,District of Oak Bay,13-4982-00,V8S 5A6,,1263 ST. DENIS,1416000,1325000,196000,1521000
2023,District of Oak Bay,13-4983-00,V8S 1T5,,1265 ST. DENIS,1614000,1387000,340000,1727000
2023,District of Oak Bay,13-4983-00,V8S 5A6,,1265 ST. DENIS,1614000,1387000,340000,1727000
2023,District of Oak Bay,13-4983-00,V8S 3X8,,1265 ST. DENIS,1614000,1387000,340000,1727000
2023,District of Oak Bay,13-4984-00,V8S 2J3,,39 MAQUINNA,4230000,2301000,1851000,4152000
2023,District of Oak Bay,13-4985-00,V8S 2J3,,43 MAQUINNA,3129200,2851000,65600,2916600
2023,District of Oak Bay,13-4986-00,V8R 1Z4,,2360 CRANMORE,1372000,1255000,237000,1492000
2023,District of Oak Bay,13-4987-00,V8R 1Z4,,2342 CRANMORE,1368000,1269000,219000,1488000
2023,District of Oak Bay,13-4988-00,V8R 1Z4,,2324 CRANMORE,1367000,1268000,215000,1483000
2023,District of Oak Bay,13-4989-00,V8R 1Z4,,2306 CRANMORE,1371000,1300000,194000,1494000
2023,District of Oak Bay,13-4990-00,V8N 1Y9,,1853 CHRISTIE,1586000,1572000,154000,1726000
2023,District of Oak Bay,13-4991-00,V8S 4J4,,1861 CHRISTIE,1477000,1373000,258000,1631000
2023,District of Oak Bay,13-4992-00,V8S 1H4,,1875 CHRISTIE,3566000,1879000,2046000,3925000
2023,District of Oak Bay,13-4993-00,V8V 2V6,,2225 CADBORO BAY,1396000,1316000,224000,1540000
2023,District of Oak Bay,13-4994-00,V8R 5S8,,1864 CHRISTIE,1327000,1215000,212000,1427000
2023,District of Oak Bay,13-4995-00,V8R 5S8,,1856 CHRISTIE,1466000,1294000,303000,1597000
2023,District of Oak Bay,13-4996-00,V8V 2V6,,2219 CADBORO BAY,1207000,1168000,145000,1313000
2023,District of Oak Bay,13-4997-00,V8R 2S4,,2211 CADBORO BAY,1210000,1135000,186000,1321000
2023,District of Oak Bay,13-4997-00,V8R 2S4,,2211 CADBORO BAY,1210000,1135000,186000,1321000
2023,District of Oak Bay,13-4998-00,V8R 5G8,,2203 CADBORO BAY,1207000,1138000,175000,1313000
2023,District of Oak Bay,13-4999-00,V8R 5G8,,2193 CADBORO BAY,1269000,1132000,253000,1385000
2023,District of Oak Bay,13-5000-00,V8R 5G8,,2181 CADBORO BAY,1125000,1043000,186000,1229000
2023,District of Oak Bay,13-5001-00,V8R 1Z3,,2212 CRANMORE,1266000,1219000,159000,1378000
2023,District of Oak Bay,13-5002-00,V8R 1Z3,,2232 CRANMORE,1336000,1164000,282000,1446000
2023,District of Oak Bay,13-5003-00,V8R 1Z3,,2252 CRANMORE,1269000,1208000,159000,1367000
2023,District of Oak Bay,13-5004-00,V0H 1R5,,2274 CRANMORE,1260000,1194000,183000,1377000
2023,District of Oak Bay,13-5005-00,V8R 1Z3,,2294 CRANMORE,1321000,1214000,234000,1448000
2023,District of Oak Bay,13-5006-00,V8P 4G8,,2340 OAK BAY,3923000,2736000,1585000,4321000
2023,District of Oak Bay,13-5006-00,V8P 4G8,,2340 OAK BAY,3923000,2736000,1585000,4321000
2023,District of Oak Bay,13-5008-00,V9Z 0T9,,2268 DALHOUSIE,1390000,1268000,268000,1536000
2023,District of Oak Bay,13-5009-00,V8R 5N6,,2274 DALHOUSIE,1330000,1262000,201000,1463000
2023,District of Oak Bay,13-5010-00,M4W 2P6,,1051 BEACH,8385000,4762000,3473000,8235000
2023,District of Oak Bay,13-5011-00,V8S 2N2,,1069 BEACH,9964000,7380000,1861000,9241000
2023,District of Oak Bay,13-5012-00,V8R 2V4,,2267 PACIFIC,1720000,1078000,867000,1945000
2023,District of Oak Bay,13-5013-00,V8R 2V4,,2277 PACIFIC,1184000,1078000,206000,1284000
2023,District of Oak Bay,13-5014-00,V8S 2M2,,330 BEACH,2816000,2552000,760000,3312000
2023,District of Oak Bay,13-5015-00,V8S 2M2,,340 BEACH,2237000,2357000,210000,2567000
2023,District of Oak Bay,13-5017-00,V8S 4X3,,480 ST. PATRICK,1922000,1726000,327000,2053000
2023,District of Oak Bay,13-5018-01,T3E 6C8,,390 BEACH,3062000,2065000,1480000,3545000
2023,District of Oak Bay,13-5018-02,V8S 4X3,,430 ST. PATRICK,3345000,2001000,1892000,3893000
2023,District of Oak Bay,13-5019-00,V8R 5S6,,2192 CRANMORE,1422000,1252000,306000,1558000
2023,District of Oak Bay,13-5019-00,V8R 1Z3,,2192 CRANMORE,1422000,1252000,306000,1558000
2023,District of Oak Bay,13-5020-00,V8S 3B6,,2172 CRANMORE,1203000,1092000,239000,1331000
2023,District of Oak Bay,13-5021-00,V8S 5B6,,2171 CADBORO BAY,1440000,1311000,284000,1595000
2023,District of Oak Bay,13-5023-00,V8S 2N2,,999 BEACH,5437000,4300000,899000,5199000
2023,District of Oak Bay,13-5024-00,,,987 BEACH,2983700,2678000,117000,2795000
2023,District of Oak Bay,13-5025-00,V8V 3K2,,2184 CADBORO BAY,5356000,3306000,2592000,5898000
2023,District of Oak Bay,13-5026-00,V8R 4N6,,2230 EASTDOWNE,1894000,1529000,453000,1982000
2023,District of Oak Bay,13-5027-00,V8R 5P7,,2193 CRANLEIGH,1146000,1132000,113000,1245000
2023,District of Oak Bay,13-5028-00,V8R 2C9,,2187 CRANLEIGH,1228000,1157000,166000,1323000
2023,District of Oak Bay,13-5029-00,V8R 2C9,,2179 CRANLEIGH,1234000,1135000,209000,1344000
2023,District of Oak Bay,13-5030-00,V8R 2E1,,2180 CRANLEIGH,1184000,1147000,140000,1287000
2023,District of Oak Bay,13-5031-00,V8R 2E1,,2188 CRANLEIGH,1195000,1140000,160000,1300000
2023,District of Oak Bay,13-5032-00,V8R 2E1,,2194 CRANLEIGH,1210000,1203000,110000,1313000
2023,District of Oak Bay,13-5033-00,V8R 2G9,,2197 FAIR,1400000,1317000,202000,1519000
2023,District of Oak Bay,13-5034-00,V8R 6K3,,2677 BEACH,2880000,1666000,1624000,3290000
2023,District of Oak Bay,13-5035-00,V8R 6K3,,2661 BEACH,1573000,1589000,130000,1719000
2023,District of Oak Bay,13-5036-00,V8W 3N7,,2400 CEDAR HILL CROSS,25624000,25739000,32000,25771000
2023,District of Oak Bay,13-5037-00,V8R 5N2,,3062 LARKDOWNE,1535000,1380000,224000,1604000
2023,District of Oak Bay,13-5038-00,V8R 5N2,,3058 LARKDOWNE,1360000,1236000,176000,1412000
2023,District of Oak Bay,13-5039-00,V8R 5N2,,3050 LARKDOWNE,1403000,1237000,227000,1464000
2023,District of Oak Bay,13-5040-00,V8R 5N2,,3042 LARKDOWNE,1484000,1237000,310000,1547000
2023,District of Oak Bay,13-5041-00,V8R 5N2,,3034 LARKDOWNE,1326000,1178000,203000,1381000
2023,District of Oak Bay,13-5042-00,V8R 5N2,,3026 LARKDOWNE,1416000,1179000,298000,1477000
2023,District of Oak Bay,13-5043-00,V8R 5N2,,3018 LARKDOWNE,1491000,1178000,397000,1575000
2023,District of Oak Bay,13-5044-00,V8R 5N2,,3010 LARKDOWNE,1356000,1178000,236000,1414000
2023,District of Oak Bay,13-5045-00,V8R 3J9,,2288 MID-DOWNE,1363000,1164000,268000,1432000
2023,District of Oak Bay,13-5046-00,V8R 5M9,,2992 LARKDOWNE,1295000,1187000,159000,1346000
2023,District of Oak Bay,13-5046-00,V7A 2Y6,,2992 LARKDOWNE,1295000,1187000,159000,1346000
2023,District of Oak Bay,13-5047-00,V8R 5M9,,2982 LARKDOWNE,1886000,1187000,807000,1994000
2023,District of Oak Bay,13-5048-00,V8R 5M9,,2972 LARKDOWNE,1288000,1168000,177000,1345000
2023,District of Oak Bay,13-5049-00,V8R 5M9,,2962 LARKDOWNE,1386000,1177000,266000,1443000
2023,District of Oak Bay,13-5050-00,V8R 5M9,,2952 LARKDOWNE,1335000,1156000,223000,1379000
2023,District of Oak Bay,13-5051-00,V8R 5M9,,2942 LARKDOWNE,1407000,1262000,204000,1466000
2023,District of Oak Bay,13-5052-00,V8R 3J2,,2117 SANDOWNE,1431000,1314000,171000,1485000
2023,District of Oak Bay,13-5053-00,V8R 3J2,,2123 SANDOWNE,1339000,1148000,236000,1384000
2023,District of Oak Bay,13-5054-00,V8R 3J2,,2129 SANDOWNE,1380000,1133000,321000,1454000
2023,District of Oak Bay,13-5055-00,V8R 3J2,,2135 SANDOWNE,1234000,1132000,151000,1283000
2023,District of Oak Bay,13-5056-00,V8R 3J3,,2126 SANDOWNE,1289000,1158000,178000,1336000
2023,District of Oak Bay,13-5057-00,V8R 5N1,,2971 LARKDOWNE,1261000,1162000,150000,1312000
2023,District of Oak Bay,13-5058-00,V8R 5N1,,2981 LARKDOWNE,1460000,1169000,346000,1515000
2023,District of Oak Bay,13-5059-00,V8R 3K1,,2305 MID-DOWNE,1366000,1168000,255000,1423000
2023,District of Oak Bay,13-5060-00,V8R 3K2,,2300 MID-DOWNE,1364000,1157000,276000,1433000
2023,District of Oak Bay,13-5061-00,V8R 5N3,,3017 LARKDOWNE,1283000,1162000,173000,1335000
2023,District of Oak Bay,13-5062-00,V8R 5N3,,3027 LARKDOWNE,1541000,1162000,482000,1644000
2023,District of Oak Bay,13-5063-00,V8R 5N3,,3035 LARKDOWNE,1332000,1161000,237000,1398000
2023,District of Oak Bay,13-5064-00,V8R 5N3,,3045 LARKDOWNE,1433000,1219000,286000,1505000
2023,District of Oak Bay,13-5065-00,V8R 5N3,,3051 LARKDOWNE,1494000,1220000,357000,1577000
2023,District of Oak Bay,13-5066-00,V8R 5N3,,3059 LARKDOWNE,1400000,1220000,248000,1468000
2023,District of Oak Bay,13-5067-00,V8R 5N3,,3063 LARKDOWNE,1408000,1219000,247000,1466000
2023,District of Oak Bay,13-5068-00,V0R 2H0,,3067 LARKDOWNE,1456000,1277000,248000,1525000
2023,District of Oak Bay,13-5069-00,V8K 1V3,,3071 LARKDOWNE,1383000,1269000,173000,1442000
2023,District of Oak Bay,13-5070-00,V8R 5N3,,3075 LARKDOWNE,1543000,1323000,288000,1611000
2023,District of Oak Bay,13-5071-00,V8P 1B9,,2301 LANSDOWNE,2679000,1498000,1477000,2975000
2023,District of Oak Bay,13-5071-00,V8R 2E4,,2301 LANSDOWNE,2679000,1498000,1477000,2975000
2023,District of Oak Bay,13-5072-00,V8P 1B9,,2311 LANSDOWNE,2102000,1659000,554000,2213000
2023,District of Oak Bay,13-5073-00,V8P 1B9,,2321 LANSDOWNE,2041000,1606000,541000,2147000
2023,District of Oak Bay,13-5074-00,V8P 1B9,,2331 LANSDOWNE,1869000,1548000,431000,1979000
2023,District of Oak Bay,13-5075-00,V8P 1B9,,2341 LANSDOWNE,1730000,1519000,294000,1813000
2023,District of Oak Bay,13-5076-00,,,112 PRINCE EDWARD,2239000,2180000,440000,2620000
2023,District of Oak Bay,13-5077-00,V8S 2K4,,116 PRINCE EDWARD,1874000,2073000,183000,2256000
2023,District of Oak Bay,13-5078-00,V8S 2K1,,120 KING GEORGE,2082000,2132000,376000,2508000
2023,District of Oak Bay,13-5079-00,V8R 5Z7,,2355 HERON,1504000,1518000,120000,1638000
2023,District of Oak Bay,13-5080-00,V8R 5Z7,,2337 HERON,1861000,1661000,364000,2025000
2023,District of Oak Bay,13-5081-00,V8R 1G2,, MONTEREY,1408000,1621000,0,1621000
2023,District of Oak Bay,13-5082-00,V8R 3P1,,2420 LANSDOWNE,2793000,2234000,864000,3098000
2023,District of Oak Bay,13-5083-00,V7K 1K3,,2450 LANSDOWNE,3714000,1971000,2118000,4089000
2023,District of Oak Bay,13-5084-00,V8S 5B4,,954 BYNG,2283000,1501000,1039000,2540000
2023,District of Oak Bay,13-5084-00,V8S 5B4,,954 BYNG,2283000,1501000,1039000,2540000
2023,District of Oak Bay,13-5085-00,V8S 5B4,,946 BYNG,2772000,1471000,1672000,3143000
2023,District of Oak Bay,13-5086-00,V8S 5B4,,926 BYNG,1515000,1435000,192000,1627000
2023,District of Oak Bay,13-5087-00,V8R 6B9,,916 BYNG,1517000,1439000,187000,1626000
2023,District of Oak Bay,13-5089-00,V8V 3Z9,,1558 BEACH,3272800,3512000,216000,3728000
2023,District of Oak Bay,13-5090-00,V8R 3C1,,2024 ALLENBY,1409000,1093000,449000,1542000
2023,District of Oak Bay,13-5091-00,V8R 3C1,,2032 ALLENBY,1157000,1123000,121000,1244000
2023,District of Oak Bay,13-5092-00,V8T 2C5,,2040 ALLENBY,1359000,1149000,331000,1480000
2023,District of Oak Bay,13-5093-00,V8R 3C1,,2048 ALLENBY,1290000,1147000,252000,1399000
2023,District of Oak Bay,13-5094-00,V8R 3C1,,2056 ALLENBY,1334000,1152000,291000,1443000
2023,District of Oak Bay,13-5095-00,V8S 2M3,,2064 ALLENBY,1256000,1138000,218000,1356000
2023,District of Oak Bay,13-5096-00,V8R 3C1,,2072 ALLENBY,1255000,1138000,224000,1362000
2023,District of Oak Bay,13-5097-00,V8R 3C1,,2080 ALLENBY,1456000,1250000,329000,1579000
2023,District of Oak Bay,13-5098-00,V8S 3M3,,2090 ALLENBY,1291000,1257000,147000,1404000
2023,District of Oak Bay,13-5099-00,V8S 2G9,,2834 HENDERSON,1422000,1293000,277000,1570000
2023,District of Oak Bay,13-5100-00,V8R 3B9,,2081 ALLENBY,1541000,1265000,408000,1673000
2023,District of Oak Bay,13-5101-00,V8R 3B9,,2073 ALLENBY,1356000,1139000,334000,1473000
2023,District of Oak Bay,13-5102-00,V8R 3B9,,2065 ALLENBY,1301000,1139000,269000,1408000
2023,District of Oak Bay,13-5103-00,V8R 3B9,,2057 ALLENBY,1449000,1138000,438000,1576000
2023,District of Oak Bay,13-5104-00,V8R 3B9,,2049 ALLENBY,1226000,1139000,164000,1303000
2023,District of Oak Bay,13-5105-00,V8R 3B9,,2041 ALLENBY,1279000,1139000,248000,1387000
2023,District of Oak Bay,13-5106-00,V8R 3B9,,2033 ALLENBY,1189000,1139000,153000,1292000
2023,District of Oak Bay,13-5107-00,V8R 3B9,,2025 ALLENBY,1219000,1139000,175000,1314000
2023,District of Oak Bay,13-5108-00,V8R 1G2,, HAMPSHIRE,234000,272000,0,272000
2023,District of Oak Bay,13-5109-00,V8R 5T7,,1703 HAMPSHIRE,1588000,1611000,130000,1741000
2023,District of Oak Bay,13-5109-01,V8R 1G2,, HAMPSHIRE,233000,271000,0,271000
2023,District of Oak Bay,13-5110-00,V8S 2H5,,2054 PENZANCE,1921000,1930000,132000,2062000
2023,District of Oak Bay,13-5111-00,V7R 3Y7,,2064 PENZANCE,2461000,1534000,1217000,2751000
2023,District of Oak Bay,13-5118-00,V8R 5V9,,1971 ST. ANN,1364000,1224000,271000,1495000
2023,District of Oak Bay,13-5119-00,V8R 5V9,,1963 ST. ANN,1224000,1146000,184000,1330000
2023,District of Oak Bay,13-5120-00,V8S 5E3,,1066 NEWPORT,1788000,1439000,531000,1970000
2023,District of Oak Bay,13-5121-00,V8S 3A4,,2568 MARGATE,1486000,1422000,172000,1594000
2023,District of Oak Bay,13-5122-00,V8S 4H9,,937 FOUL BAY,1773000,1696000,217000,1913000
2023,District of Oak Bay,13-5123-00,V8S 4Y6,,2379 LYN,1371000,1337000,135000,1472000
2023,District of Oak Bay,13-5124-00,V8S 4Y6,,2381 LYN,1384000,1338000,148000,1486000
2023,District of Oak Bay,13-5125-00,V8S 4Y6,,2383 LYN,1842000,1308000,685000,1993000
2023,District of Oak Bay,13-5126-00,V8S 4Y6,,2385 LYN,1509000,1298000,334000,1632000
2023,District of Oak Bay,13-5127-00,V8S 2V5,, RUNNYMEDE,80400,86200,0,86200
2023,District of Oak Bay,13-5128-00,V8Z 1E8,,2121 CADBORO BAY,2033000,2347000,0,2347000
2023,District of Oak Bay,13-5129-00,V8R 1G2,,2121 CADBORO BAY,2199000,2534000,0,2534000
2023,District of Oak Bay,13-5130-00,V8S 5C4,,905 LINKLEAS,1442000,1405000,140000,1545000
2023,District of Oak Bay,13-8452-06,V8R 6G7,401,1175 BEACH,1086000,893000,341000,1234000
2023,District of Oak Bay,13-8452-07,V8S 2N2,402,1175 BEACH,1106000,906000,350000,1256000
2023,District of Oak Bay,13-8452-08,V8S 2N2,403,1175 BEACH,1171000,947000,378000,1325000
2023,District of Oak Bay,13-8452-09,V8S 2N2,404,1175 BEACH,1057000,896000,312000,1208000
2023,District of Oak Bay,13-8452-10,V8V 3K4,405,1175 BEACH,1787000,1679000,382000,2061000
2023,District of Oak Bay,13-8452-11,T2V 1H7,406,1175 BEACH,1227000,1147000,254000,1401000
2023,District of Oak Bay,13-8452-12,V8S 2N2,407,1175 BEACH,1718000,1623000,362000,1985000
2023,District of Oak Bay,13-8452-13,V0R 3A0,408,1175 BEACH,1863000,1740000,405000,2145000
2023,District of Oak Bay,13-8452-14,V5K 1E6,409,1175 BEACH,1806000,1694000,388000,2082000
2023,District of Oak Bay,13-8452-14,T4L 2N3,409,1175 BEACH,1806000,1694000,388000,2082000
2023,District of Oak Bay,13-8452-15,V1C 3B7,410,1175 BEACH,2087000,1917000,472000,2389000
2023,District of Oak Bay,13-8452-16,V8S 2N2,411,1175 BEACH,2068000,1903000,467000,2370000
2023,District of Oak Bay,13-8452-17,V8S 2N2,412,1175 BEACH,1657000,1478000,418000,1896000
2023,District of Oak Bay,13-8452-18,V8S 2N2,413,1175 BEACH,883000,775000,244000,1019000
2023,District of Oak Bay,13-8452-19,V8S 2N2,414,1175 BEACH,871000,748000,252000,1000000
2023,District of Oak Bay,13-8452-20,V8S 2N2,415,1175 BEACH,1272000,1069000,395000,1464000
2023,District of Oak Bay,13-8452-21,V8S 2N2,501,1175 BEACH,1574000,1328000,508000,1836000
2023,District of Oak Bay,13-8452-22,T3Z 3B3,502,1175 BEACH,2899000,2847000,685000,3532000
2023,District of Oak Bay,13-8452-23,V1M 2N1,503,1175 BEACH,2290000,2402000,484000,2886000
2023,District of Oak Bay,13-8452-24,V4X 1C7,504,1175 BEACH,2330000,2294000,540000,2834000
2023,District of Oak Bay,13-8452-25,V8S 2N2,505,1175 BEACH,2457000,2395000,580000,2975000
2023,District of Oak Bay,13-8452-26,V4X 1C7,G101,1175 BEACH,195100,142000,76100,218100
2023,District of Oak Bay,13-8452-27,V4X 1C7,G102,1175 BEACH,178300,130000,69700,199700
2023,District of Oak Bay,13-8452-28,V4X 1C7,G103,1175 BEACH,184300,134000,71800,205800
2023,District of Oak Bay,13-8452-29,V4X 1C7,G104,1175 BEACH,184300,134000,71800,205800
2023,District of Oak Bay,13-8452-30,V4X 1C7,G105,1175 BEACH,177900,129000,69100,198100
2023,District of Oak Bay,13-8452-31,T8A 5L4,G106,1175 BEACH,171400,125000,66600,191600
2023,District of Oak Bay,13-8452-32,V4X 1C7,G201,1175 BEACH,203600,152000,75500,227500
2023,District of Oak Bay,13-8452-33,V4X 1C7,G202,1175 BEACH,179500,134000,66400,200400
2023,District of Oak Bay,13-8452-34,T2R 0C8,G203,1175 BEACH,237800,177400,88100,265500
2023,District of Oak Bay,13-8452-35,V4X 1C7,G204,1175 BEACH,225800,168000,83600,251600
2023,District of Oak Bay,13-8452-36,V4X 1C7,G205,1175 BEACH,190000,142000,70400,212400
2023,District of Oak Bay,13-8452-37,V4X 1C7,G206,1175 BEACH,241200,180000,89600,269600
2023,District of Oak Bay,13-8452-38,V4X 1C7,211,1175 BEACH,121500,72800,63000,135800
2023,District of Oak Bay,13-8452-39,V4X 1C7,212,1175 BEACH,118100,70700,61200,131900
2023,District of Oak Bay,13-8452-40,V4X 1C7,213,1175 BEACH,118300,70900,61300,132200
2023,District of Oak Bay,13-8452-41,V2A 1A3,214,1175 BEACH,118300,70900,61300,132200
2023,District of Oak Bay,13-8452-42,V4X 1C7,215,1175 BEACH,118300,70900,61300,132200
2023,District of Oak Bay,13-8452-43,V4X 1C7,216,1175 BEACH,118300,70900,61300,132200
2023,District of Oak Bay,13-8452-44,V4X 1C7,217,1175 BEACH,116400,69700,60300,130000
2023,District of Oak Bay,13-8452-45,V4X 1C7,218,1175 BEACH,179800,107000,93200,200200
2023,District of Oak Bay,13-8452-46,V4X 1C7,219,1175 BEACH,257100,203000,85000,288000
2023,District of Oak Bay,13-8452-47,V4X 1C7,220,1175 BEACH,205800,162000,68000,230000
2023,District of Oak Bay,13-8452-48,V4X 1C7,221,1175 BEACH,160500,126000,53100,179100
2023,District of Oak Bay,13-8452-49,V4X 1C7,222,1175 BEACH,177700,140000,58900,198900
2023,District of Oak Bay,13-8452-50,V4X 1C7,223,1175 BEACH,195900,154000,64600,218600
2023,District of Oak Bay,13-8452-51,V4X 1C7,224,1175 BEACH,234400,185000,77600,262600
2023,District of Oak Bay,13-8452-52,V4X 1C7,225,1175 BEACH,184800,146000,61200,207200
2023,District of Oak Bay,13-8452-53,V9A 7R1,226,1175 BEACH,211400,166000,69800,235800
2023,District of Oak Bay,13-8452-54,V4X 1C7,227,1175 BEACH,288300,227000,95300,322300
2023,District of Oak Bay,13-8452-55,V4X 1C7,228,1175 BEACH,117800,70600,61100,131700
2023,District of Oak Bay,13-8452-56,V4X 1C7,229,1175 BEACH,129100,77400,66900,144300
2023,District of Oak Bay,13-8452-57,V4X 1C7,230,1175 BEACH,127900,76600,66300,142900
2023,District of Oak Bay,13-8452-58,V4X 1C7,231,1175 BEACH,125700,75300,65200,140500
2023,District of Oak Bay,13-8452-59,V4X 1C7,232,1175 BEACH,127700,76500,66200,142700
2023,District of Oak Bay,13-8452-60,T3E 4J2,233,1175 BEACH,116600,63500,66800,130300
2023,District of Oak Bay,13-8452-61,V4X 1C7,234,1175 BEACH,104300,56800,59800,116600
2023,District of Oak Bay,13-8452-62,V4X 1C7,235,1175 BEACH,108800,59200,62300,121500
2023,District of Oak Bay,13-8452-63,V4X 1C7,236,1175 BEACH,139400,75900,79900,155800
2023,District of Oak Bay,13-8452-64,V4X 1C7,237,1175 BEACH,87700,41800,56200,98000
2023,District of Oak Bay,13-8452-65,V4X 1C7,238,1175 BEACH,101700,48500,65200,113700
2023,District of Oak Bay,13-8452-66,V4X 1C7,239,1175 BEACH,92300,44000,59100,103100
2023,District of Oak Bay,13-8452-67,V4X 1C7,201,1175 BEACH,96800,46100,62000,108100
2023,District of Oak Bay,13-8452-68,V4X 1C7,202,1175 BEACH,92500,44100,59300,103400
2023,District of Oak Bay,13-8452-69,V8R 2E2,203,1175 BEACH,73600,35100,47200,82300
2023,District of Oak Bay,13-8452-70,V4X 1C7,204,1175 BEACH,79700,38000,51100,89100
2023,District of Oak Bay,13-8452-71,V4X 1C7,205,1175 BEACH,93200,44400,59700,104100
2023,District of Oak Bay,13-8452-72,V4X 1C7,206,1175 BEACH,144300,68900,92500,161400
2023,District of Oak Bay,13-8452-73,V0R 1T0,207,1175 BEACH,79700,38000,51000,89000
2023,District of Oak Bay,13-8452-74,V4X 1C7,208,1175 BEACH,134800,73400,77200,150600
2023,District of Oak Bay,13-8452-75,V4X 1C7,209,1175 BEACH,147300,80200,84400,164600
2023,District of Oak Bay,13-8452-76,V4X 1C7,210,1175 BEACH,162000,88200,92800,181000
2023,District of Oak Bay,13-8452-77,V4X 1C7,311,1175 BEACH,127300,79300,63000,142300
2023,District of Oak Bay,13-8452-78,V4X 1C7,312,1175 BEACH,123700,77000,61200,138200
2023,District of Oak Bay,13-8452-79,V4X 1C7,313,1175 BEACH,124000,77200,61300,138500
2023,District of Oak Bay,13-8452-80,V4X 1C7,314,1175 BEACH,124000,77200,61300,138500
2023,District of Oak Bay,13-8452-81,V4X 1C7,315,1175 BEACH,124000,77200,61300,138500
2023,District of Oak Bay,13-8452-82,V4X 1C7,316,1175 BEACH,124000,77200,61300,138500
2023,District of Oak Bay,13-8452-83,V4X 1C7,317,1175 BEACH,121900,75900,60300,136200
2023,District of Oak Bay,13-8452-84,V4X 1C7,318,1175 BEACH,188400,117000,93200,210200
2023,District of Oak Bay,13-8452-85,V4X 1C7,319,1175 BEACH,265100,211000,85000,296000
2023,District of Oak Bay,13-8452-86,V4X 1C7,320,1175 BEACH,211800,169000,68000,237000
2023,District of Oak Bay,13-8452-87,V4X 1C7,321,1175 BEACH,165500,132000,53100,185100
2023,District of Oak Bay,13-8452-88,V4X 1C7,322,1175 BEACH,183700,146000,58900,204900
2023,District of Oak Bay,13-8452-89,V4X 1C7,323,1175 BEACH,201900,161000,64600,225600
2023,District of Oak Bay,13-8452-90,V4X 1C7,324,1175 BEACH,242400,193000,77600,270600
2023,District of Oak Bay,13-8452-91,V4X 1C7,325,1175 BEACH,190800,152000,61200,213200
2023,District of Oak Bay,13-8452-92,V4X 1C7,326,1175 BEACH,217600,174000,69900,243900
2023,District of Oak Bay,13-8452-93,V4X 1C7,327,1175 BEACH,297300,237000,95300,332300
2023,District of Oak Bay,13-8452-94,V4X 1C7,328,1175 BEACH,123400,76800,61100,137900
2023,District of Oak Bay,13-8452-95,V4X 1C7,329,1175 BEACH,135300,84300,66900,151200
2023,District of Oak Bay,13-8452-96,V4X 1C7,330,1175 BEACH,134000,83500,66300,149800
2023,District of Oak Bay,13-8452-97,V4X 1C7,331,1175 BEACH,131700,82000,65200,147200
2023,District of Oak Bay,13-8452-98,V4X 1C7,332,1175 BEACH,133700,83300,66200,149500
2023,District of Oak Bay,13-8452-99,V6N 1H7,333,1175 BEACH,122700,70300,66800,137100
2023,District of Oak Bay,13-8453-00,V4X 1C7,334,1175 BEACH,109800,62900,59800,122700
2023,District of Oak Bay,13-8453-01,V4X 1C7,335,1175 BEACH,114500,65600,62300,127900
2023,District of Oak Bay,13-8453-02,V4X 1C7,336,1175 BEACH,146800,84100,79900,164000
2023,District of Oak Bay,13-8453-03,V4X 1C7,337,1175 BEACH,92700,47500,56100,103600
2023,District of Oak Bay,13-8453-04,V4X 1C7,338,1175 BEACH,107900,55300,65300,120600
2023,District of Oak Bay,13-8453-05,V4X 1C7,339,1175 BEACH,97400,49900,58900,108800
2023,District of Oak Bay,13-8453-06,V4X 1C7,301,1175 BEACH,102500,52500,62000,114500
2023,District of Oak Bay,13-8453-07,V4X 1C7,302,1175 BEACH,97900,50200,59300,109500
2023,District of Oak Bay,13-8453-08,V4X 1C7,303,1175 BEACH,78100,40000,47200,87200
2023,District of Oak Bay,13-8453-09,V4X 1C7,304,1175 BEACH,84200,43200,50900,94100
2023,District of Oak Bay,13-8453-10,V4X 1C7,305,1175 BEACH,98600,50500,59700,110200
2023,District of Oak Bay,13-8453-11,981-0962,306,1175 BEACH,152800,78300,92500,170800
2023,District of Oak Bay,13-8453-12,V4X 1C7,307,1175 BEACH,84400,43300,51100,94400
2023,District of Oak Bay,13-8453-13,V4X 1C7,308,1175 BEACH,141800,81300,77200,158500
2023,District of Oak Bay,13-8453-14,V4X 1C7,309,1175 BEACH,155000,88800,84400,173200
2023,District of Oak Bay,13-8453-15,V4X 1C7,310,1175 BEACH,170600,97700,92800,190500
2023,District of Oak Bay,13-8453-16,V4X 1C7,506,1175 BEACH,435000,349000,137000,486000
2023,District of Oak Bay,13-8453-17,V4X 1C7,507,1175 BEACH,473000,374000,155000,529000
2023,District of Oak Bay,13-8453-18,V4X 1C7,508,1175 BEACH,306000,249000,92700,341700
2023,District of Oak Bay,13-8453-19,V4X 1C7,509,1175 BEACH,126400,83900,57300,141200
2023,District of Oak Bay,13-8453-20,V4X 1C7,510,1175 BEACH,131000,86900,59400,146300
2023,District of Oak Bay,13-8453-21,V4X 1C7,511,1175 BEACH,141400,93900,64100,158000
2023,District of Oak Bay,13-8453-22,V4X 1C7,512,1175 BEACH,190500,126000,86500,212500
2023,District of Oak Bay,13-8453-23,V4X 1C7,513,1175 BEACH,103300,59200,56200,115400
2023,District of Oak Bay,13-8453-24,V4X 1C7,514,1175 BEACH,112500,64400,61200,125600
2023,District of Oak Bay,13-8453-25,V4X 1C7,515,1175 BEACH,108600,62300,59100,121400
2023,District of Oak Bay,14-5130-00,V8P 0A5,,2351 LANSDOWNE,1724000,1521000,285000,1806000
2023,District of Oak Bay,14-5131-00,V8P 1B9,,2361 LANSDOWNE,1737000,1541000,277000,1818000
2023,District of Oak Bay,14-5132-00,V8P 1C1,,2371 LANSDOWNE,1910000,1485000,557000,2042000
2023,District of Oak Bay,14-5133-00,V8P 1C1,,2381 LANSDOWNE,1555000,1358000,266000,1624000
2023,District of Oak Bay,14-5134-00,V8R 5S1,,3089 EASTDOWNE,1506000,1356000,216000,1572000
2023,District of Oak Bay,14-5135-00,V8R 5S1,,3075 EASTDOWNE,1494000,1229000,355000,1584000
2023,District of Oak Bay,14-5136-00,V8R 5S1,,3065 EASTDOWNE,1487000,1170000,386000,1556000
2023,District of Oak Bay,14-5137-00,V8R 5S1,,3057 EASTDOWNE,1607000,1229000,465000,1694000
2023,District of Oak Bay,14-5138-00,V8R 5S1,,3045 EASTDOWNE,1221000,1170000,97600,1267600
2023,District of Oak Bay,14-5139-00,V8R 5S1,,3035 EASTDOWNE,1286000,1170000,166000,1336000
2023,District of Oak Bay,14-5140-00,V8R 5S1,,3025 EASTDOWNE,1299000,1170000,183000,1353000
2023,District of Oak Bay,14-5141-00,V8R 5S1,,3015 EASTDOWNE,2337000,1170000,1540000,2710000
2023,District of Oak Bay,14-5142-00,V8R 5S1,,2999 EASTDOWNE,1295000,1171000,172000,1343000
2023,District of Oak Bay,14-5143-00,V8R 5S1,,2991 EASTDOWNE,1281000,1162000,169000,1331000
2023,District of Oak Bay,14-5144-00,V8R 5S1,,2985 EASTDOWNE,1342000,1164000,234000,1398000
2023,District of Oak Bay,14-5145-00,V8R 5S1,,2977 EASTDOWNE,1296000,1155000,193000,1348000
2023,District of Oak Bay,14-5146-00,V8R 5S1,,2967 EASTDOWNE,1343000,1246000,148000,1394000
2023,District of Oak Bay,14-5147-00,V8R 5S1,,2959 EASTDOWNE,1505000,1200000,375000,1575000
2023,District of Oak Bay,14-5148-00,V6H 1S5,,2951 EASTDOWNE,1224000,1108000,166000,1274000
2023,District of Oak Bay,14-5149-00,V8R 5S1,,2945 EASTDOWNE,1260000,1108000,202000,1310000
2023,District of Oak Bay,14-5151-00,R2W 3W7,,2189 SANDOWNE,1252000,1133000,177000,1310000
2023,District of Oak Bay,14-5152-00,V8R 5R8,,2936 EASTDOWNE,1254000,1133000,172000,1305000
2023,District of Oak Bay,14-5153-00,V8R 3J2,,2183 SANDOWNE,1266000,1160000,155000,1315000
2023,District of Oak Bay,14-5154-00,V8R 3J2,,2177 SANDOWNE,1413000,1161000,288000,1449000
2023,District of Oak Bay,14-5155-00,V8R 3J2,,2171 SANDOWNE,1337000,1161000,219000,1380000
2023,District of Oak Bay,14-5156-00,V8R 3J2,,2165 SANDOWNE,1268000,1156000,162000,1318000
2023,District of Oak Bay,14-5157-00,V8R 3J2,,2159 SANDOWNE,1321000,1145000,230000,1375000
2023,District of Oak Bay,14-5158-00,V8R 3J2,,2153 SANDOWNE,1287000,1135000,210000,1345000
2023,District of Oak Bay,14-5159-00,V8R 3J2,,2147 SANDOWNE,1378000,1133000,271000,1404000
2023,District of Oak Bay,14-5160-00,V1N 4G2,,2141 SANDOWNE,1245000,1135000,161000,1296000
2023,District of Oak Bay,14-5161-00,V8R 5N7,,2964 OAKDOWNE,1335000,1162000,226000,1388000
2023,District of Oak Bay,14-5162-00,V8R 5N7,,2974 OAKDOWNE,1316000,1149000,205000,1354000
2023,District of Oak Bay,14-5163-00,V8R 5N7,,2984 OAKDOWNE,1265000,1156000,159000,1315000
2023,District of Oak Bay,14-5164-00,V8R 5N7,,2994 OAKDOWNE,2503000,1177000,1609000,2786000
2023,District of Oak Bay,14-5165-00,V8R 5N9,,3008 OAKDOWNE,1501000,1304000,266000,1570000
2023,District of Oak Bay,14-5166-00,V8R 5N9,,3014 OAKDOWNE,1402000,1262000,195000,1457000
2023,District of Oak Bay,14-5167-00,V8R 5N9,,3020 OAKDOWNE,1448000,1263000,254000,1517000
2023,District of Oak Bay,14-5168-00,V8R 5N9,,3026 OAKDOWNE,1505000,1263000,315000,1578000
2023,District of Oak Bay,14-5169-00,V8R 5N9,,3032 OAKDOWNE,1462000,1262000,272000,1534000
2023,District of Oak Bay,14-5170-00,V8R 5N9,,3038 OAKDOWNE,1454000,1263000,260000,1523000
2023,District of Oak Bay,14-5171-00,V1R 2W9,,3044 OAKDOWNE,1562000,1263000,361000,1624000
2023,District of Oak Bay,14-5172-00,V8R 5N9,,3050 OAKDOWNE,1391000,1262000,191000,1453000
2023,District of Oak Bay,14-5173-00,V8R 5N9,,3056 OAKDOWNE,1747000,1440000,357000,1797000
2023,District of Oak Bay,14-5173-00,V8R 5N9,,3056 OAKDOWNE,1747000,1440000,357000,1797000
2023,District of Oak Bay,14-5174-00,V8R 5N9,,3062 OAKDOWNE,1555000,1381000,243000,1624000
2023,District of Oak Bay,14-5175-00,V8R 5N9,,3068 OAKDOWNE,1552000,1332000,293000,1625000
2023,District of Oak Bay,14-5176-00,V8R 5N9,,3074 OAKDOWNE,1510000,1364000,212000,1576000
2023,District of Oak Bay,14-5177-00,V8R 5N9,,3080 OAKDOWNE,1471000,1322000,215000,1537000
2023,District of Oak Bay,14-5178-00,V8R 5N9,,3088 OAKDOWNE,1490000,1352000,192000,1544000
2023,District of Oak Bay,14-5179-00,V8R 5P1,,3087 OAKDOWNE,1626000,1343000,351000,1694000
2023,District of Oak Bay,14-5180-00,V8R 5P1,,3081 OAKDOWNE,1494000,1290000,262000,1552000
2023,District of Oak Bay,14-5181-00,V8R 5P1,,3075 OAKDOWNE,1444000,1299000,208000,1507000
2023,District of Oak Bay,14-5182-00,V8R 5P1,,3067 OAKDOWNE,1527000,1331000,270000,1601000
2023,District of Oak Bay,14-5183-00,V8R 5P1,,3059 OAKDOWNE,1439000,1303000,200000,1503000
2023,District of Oak Bay,14-5184-00,V8R 5P1,,3051 OAKDOWNE,1440000,1257000,250000,1507000
2023,District of Oak Bay,14-5185-00,V8R 3K5,,2324 MID-DOWNE,2501000,1157000,1584000,2741000
2023,District of Oak Bay,14-5186-00,V8R 3K5,,2334 MID-DOWNE,1465000,1204000,331000,1535000
2023,District of Oak Bay,14-5187-00,V8R 3K5,,2344 MID-DOWNE,1446000,1233000,274000,1507000
2023,District of Oak Bay,14-5190-00,V8R 3K4,,2341 MID-DOWNE,1290000,1173000,170000,1343000
2023,District of Oak Bay,14-5191-00,V8R 5R9,,2988 EASTDOWNE,1245000,1075000,221000,1296000
2023,District of Oak Bay,14-5191-00,V4K 1R9,,2988 EASTDOWNE,1245000,1075000,221000,1296000
2023,District of Oak Bay,14-5192-00,V8R 5R9,,2978 EASTDOWNE,1285000,1150000,185000,1335000
2023,District of Oak Bay,14-5193-00,V8R 5R9,,2968 EASTDOWNE,1287000,1166000,174000,1340000
2023,District of Oak Bay,14-5194-00,V8R 5R9,,2958 EASTDOWNE,1229000,1015000,276000,1291000
2023,District of Oak Bay,14-5195-00,V8R 3J5,,2190 SANDOWNE,1424000,1039000,542000,1581000
2023,District of Oak Bay,14-5196-00,V8R 5P2,,2961 ASHDOWNE,1155000,1046000,155000,1201000
2023,District of Oak Bay,14-5197-00,V8R 5P2,,2973 ASHDOWNE,1277000,1045000,280000,1325000
2023,District of Oak Bay,14-5198-00,V8R 5P2,,2981 ASHDOWNE,1294000,1041000,320000,1361000
2023,District of Oak Bay,14-5199-00,V8R 5P2,,2989 ASHDOWNE,1298000,1038000,323000,1361000
2023,District of Oak Bay,14-5200-00,V8R 3K4,,2331 MID-DOWNE,1145000,1038000,152000,1190000
2023,District of Oak Bay,14-5201-00,V8R 3K3,,2319 MID-DOWNE,1402000,1139000,328000,1467000
2023,District of Oak Bay,14-5202-00,V8R 5P3,,2986 ASHDOWNE,1369000,1104000,311000,1415000
2023,District of Oak Bay,14-5203-00,V8R 5P3,,2976 ASHDOWNE,1272000,1097000,225000,1322000
2023,District of Oak Bay,14-5204-00,V8R 5P3,,2966 ASHDOWNE,1215000,1100000,164000,1264000
2023,District of Oak Bay,14-5205-00,V8R 3J4,,2170 SANDOWNE,1305000,1124000,240000,1364000
2023,District of Oak Bay,14-5206-00,V8R 5N8,,2965 OAKDOWNE,1296000,1168000,179000,1347000
2023,District of Oak Bay,14-5207-00,V8R 5N8,,2975 OAKDOWNE,1481000,1191000,369000,1560000
2023,District of Oak Bay,14-5208-00,V8R 5N8,,2985 OAKDOWNE,1325000,1182000,190000,1372000
2023,District of Oak Bay,14-5209-00,V8R 3C3,,2313 MID-DOWNE,1448000,1211000,309000,1520000
2023,District of Oak Bay,14-5209-00,V8R 3C3,,2313 MID-DOWNE,1448000,1211000,309000,1520000
2023,District of Oak Bay,14-5210-00,V8R 1G2,, OAKDOWNE,1785000,2056000,0,2056000
2023,District of Oak Bay,14-5211-00,V8V 3V7,,1745 ELGIN,916200,1047000,11500,1058500
2023,District of Oak Bay,14-5212-00,V8R 1M1,,2120 BYRON,1053000,1029000,117000,1146000
2023,District of Oak Bay,14-5213-00,V8R 5N6,,1654 YALE,1289000,1087000,329000,1416000
2023,District of Oak Bay,14-5217-00,V8R 1G2,, MAQUINNA,2343000,2711000,0,2711000
2023,District of Oak Bay,14-5218-02,V8S 2J8,,231 KING GEORGE,4168000,2553000,2219000,4772000
2023,District of Oak Bay,14-5218-03,V8S 2J8,,233 KING GEORGE,3475000,3059000,2445000,5504000
2023,District of Oak Bay,14-5218-04,V8T 1K5,,235 KING GEORGE,6430000,3150000,2983000,6133000
2023,District of Oak Bay,14-5218-05,V8S 2J8,,239 KING GEORGE,4305000,2620000,2299000,4919000
2023,District of Oak Bay,14-5219-00,V8R 2H5,,2367 DALHOUSIE,1460000,1448000,144000,1592000
2023,District of Oak Bay,14-5220-00,V8R 2H5,,2389 DALHOUSIE,1471000,1443000,163000,1606000
2023,District of Oak Bay,14-5222-00,V8X 5C1,,2130 FAIR,1456000,1325000,281000,1606000
2023,District of Oak Bay,14-5223-00,V8R 2H1,,2140 FAIR,1250000,1235000,126000,1361000
2023,District of Oak Bay,14-5224-00,V8P 5A8,,2150 FAIR,1615000,1541000,238000,1779000
2023,District of Oak Bay,14-5224-00,V8P 5A8,,2150 FAIR,1615000,1541000,238000,1779000
2023,District of Oak Bay,14-5224-00,V8P 3W6,,2150 FAIR,1615000,1541000,238000,1779000
2023,District of Oak Bay,14-5224-00,V8P 3W6,,2150 FAIR,1615000,1541000,238000,1779000
2023,District of Oak Bay,14-5226-00,V8S 2J5,,2170 FAIR,1180500,1185000,95600,1280600
2023,District of Oak Bay,14-5227-00,V8R 2H1,,2180 FAIR,1227000,1183000,150000,1333000
2023,District of Oak Bay,14-5231-00,V8R 5P8,,2482 EASTDOWNE,1300000,1269000,145000,1414000
2023,District of Oak Bay,14-5232-00,V8R 5P7,,2487 EASTDOWNE,1264000,1191000,183000,1374000
2023,District of Oak Bay,14-5233-00,V8R 5N8,,2493 EASTDOWNE,1249000,1217000,140000,1357000
2023,District of Oak Bay,14-5233-00,V8R 5P7,,2493 EASTDOWNE,1249000,1217000,140000,1357000
2023,District of Oak Bay,14-5234-00,V8R 5P7,,2499 EASTDOWNE,1297000,1253000,156000,1409000
2023,District of Oak Bay,14-5235-00,V8R 5P7,,2505 EASTDOWNE,1299000,1266000,148000,1414000
2023,District of Oak Bay,14-5236-00,V8R 2N3,,2201 KINROSS,1266000,1223000,154000,1377000
2023,District of Oak Bay,14-5237-00,T3E 6G6,,2450 MOWAT,1157000,1126000,134000,1260000
2023,District of Oak Bay,14-5238-00,V8R 5S9,,2470 MOWAT,1148400,1143000,99900,1242900
2023,District of Oak Bay,14-5239-00,V8R 5S9,,2490 MOWAT,1185000,1143000,133000,1276000
2023,District of Oak Bay,14-5240-00,V8R 5S9,,2500 MOWAT,1170000,1097000,168000,1265000
2023,District of Oak Bay,14-5241-00,V8R 2N3,,2203 KINROSS,1157000,1121000,137000,1258000
2023,District of Oak Bay,14-5242-00,V8R 2N3,,2205 KINROSS,1198000,1112000,186000,1298000
2023,District of Oak Bay,14-5243-00,V8R 2N5,,2200 KINROSS,1331000,1223000,215000,1438000
2023,District of Oak Bay,14-5244-00,V8R 2N5,,2202 KINROSS,1299000,1197000,213000,1410000
2023,District of Oak Bay,14-5245-00,V8R 2N5,,2208 KINROSS,1239000,1158000,182000,1340000
2023,District of Oak Bay,14-5246-00,V8R 2N5,,2218 KINROSS,1066000,1158000,638000,1796000
2023,District of Oak Bay,14-5247-00,V8R 2N5,,2224 KINROSS,1191000,1158000,136000,1294000
2023,District of Oak Bay,14-5248-00,V8R 2N5,,2230 KINROSS,1231000,1158000,177000,1335000
2023,District of Oak Bay,14-5249-00,V8R 2N5,,2236 KINROSS,1425000,1158000,409000,1567000
2023,District of Oak Bay,14-5250-00,V8R 2N5,,2240 KINROSS,1225000,1158000,169000,1327000
2023,District of Oak Bay,14-5251-00,V8R 2N5,,2244 KINROSS,1212000,1152000,157000,1309000
2023,District of Oak Bay,14-5252-00,V8R 2N4,,2211 KINROSS,1390000,1329000,180000,1509000
2023,District of Oak Bay,14-5253-00,V8R 2N4,,2221 KINROSS,1270000,1183000,198000,1381000
2023,District of Oak Bay,14-5254-00,V8R 2N4,,2231 KINROSS,1247000,1195000,161000,1356000
2023,District of Oak Bay,14-5255-00,V8R 2N4,,2241 KINROSS,1219000,1190000,134000,1324000
2023,District of Oak Bay,14-5256-00,V8R 2N4,,2251 KINROSS,1212000,1190000,128000,1318000
2023,District of Oak Bay,14-5257-00,V8R 5A3,,2530 CADBORO BAY,1116000,1086000,128000,1214000
2023,District of Oak Bay,14-5258-00,V8R 5H9,,2520 CADBORO BAY,1135000,1038000,192000,1230000
2023,District of Oak Bay,14-5259-00,V8R 5H9,,2510 CADBORO BAY,1148000,1039000,209000,1248000
2023,District of Oak Bay,14-5260-00,V8R 5H9,,2500 CADBORO BAY,1113000,1022000,188000,1210000
2023,District of Oak Bay,14-5261-00,V8R 2M7,,2250 WOODHOUSE,1404000,1144000,567000,1711000
2023,District of Oak Bay,14-5262-00,V8R 2M7,,2240 WOODHOUSE,1591000,1151000,572000,1723000
2023,District of Oak Bay,14-5263-00,V8R 2M7,,2230 WOODHOUSE,1192000,1157000,138000,1295000
2023,District of Oak Bay,14-5264-00,V8R 2M7,,2220 WOODHOUSE,1260000,1163000,201000,1364000
2023,District of Oak Bay,14-5265-00,V8R 2M7,,2210 WOODHOUSE,1313000,1170000,263000,1433000
2023,District of Oak Bay,14-5266-00,V8R 2N4,,2209 KINROSS,1186000,1127000,168000,1295000
2023,District of Oak Bay,14-5267-00,V8R 2M7,,2206 WOODHOUSE,1185000,1157000,133000,1290000
2023,District of Oak Bay,14-5268-00,V8R 5T1,,2491 MOWAT,1147000,1101000,143000,1244000
2023,District of Oak Bay,14-5269-00,V8R 5T1,,2467 MOWAT,1144000,1107000,136000,1243000
2023,District of Oak Bay,14-5270-00,V8R 5T1,,2455 MOWAT,1161000,1100000,160000,1260000
2023,District of Oak Bay,14-5271-00,V8R 5T1,,2441 MOWAT,1146000,1093000,152000,1245000
2023,District of Oak Bay,14-5272-00,V8R 5T2,,2490 DRYFE,1351000,1108000,339000,1447000
2023,District of Oak Bay,14-5273-00,V8R 5T2,,2474 DRYFE,1319000,1113000,322000,1435000
2023,District of Oak Bay,14-5274-00,V8R 5T2,,2458 DRYFE,1270000,1107000,288000,1395000
2023,District of Oak Bay,14-5275-00,V8R 5T2,,2446 DRYFE,1149000,1102000,147000,1249000
2023,District of Oak Bay,14-5276-00,V8R 5T3,,2491 DRYFE,1226000,1131000,189000,1320000
2023,District of Oak Bay,14-5277-00,V8R 5T3,,2471 DRYFE,1172000,1139000,136000,1275000
2023,District of Oak Bay,14-5278-00,V8R 5T3,,2451 DRYFE,1212000,1159000,156000,1315000
2023,District of Oak Bay,14-5279-00,V8R 5H6,,2490 CADBORO BAY,1076000,988000,178000,1166000
2023,District of Oak Bay,14-5280-00,V8N 2M9,,2470 CADBORO BAY,1057000,1003000,144000,1147000
2023,District of Oak Bay,14-5281-00,V8R 5H6,,2450 CADBORO BAY,1071000,1013000,152000,1165000
2023,District of Oak Bay,14-5282-00,V8N 3W3,,2897 FOUL BAY,1676000,1308000,405000,1713000
2023,District of Oak Bay,14-5283-00,V8N 3W3,,2867 FOUL BAY,1016700,809000,457000,1266000
2023,District of Oak Bay,14-5284-00,V7W 2S2,,2865 FOUL BAY,922000,648000,294000,942000
2023,District of Oak Bay,14-5284-00,V7V 2S9,,2865 FOUL BAY,922000,648000,294000,942000
2023,District of Oak Bay,14-5285-00,V6P 6G5,,2851 FOUL BAY,1560000,1133000,717000,1850000
2023,District of Oak Bay,14-5286-00,V8R 1R5,,2192 CUBBON,1422000,1369000,175000,1544000
2023,District of Oak Bay,14-5287-00,V8R 1R5,,2182 CUBBON,1845000,1581000,439000,2020000
2023,District of Oak Bay,14-5288-00,,,2172 CUBBON,1679000,1631000,192000,1823000
2023,District of Oak Bay,14-5288-00,,,2172 CUBBON,1679000,1631000,192000,1823000
2023,District of Oak Bay,14-5289-00,V8R 1R5,,2164 CUBBON,2045000,1771000,475000,2246000
2023,District of Oak Bay,14-5290-00,V8R 1R4,,2195 CUBBON,1410000,1329000,204000,1533000
2023,District of Oak Bay,14-5291-00,V8R 1R4,,2185 CUBBON,1497000,1435000,192000,1627000
2023,District of Oak Bay,14-5293-10,V8R 1R4,,2155 CUBBON,2548000,1402000,1468000,2870000
2023,District of Oak Bay,14-5293-20,V8R 1R4,,2157 CUBBON,2898000,2487000,774000,3261000
2023,District of Oak Bay,14-5295-00,V8R 6E7,,3500 UPPER TERRACE,1705000,1789000,40500,1829500
2023,District of Oak Bay,14-5298-00,V6P 5R8,,3565 BEACH,4086000,3260000,635000,3895000
2023,District of Oak Bay,14-5299-00,V8R 6A1,,2840 LINCOLN,2267000,2159000,310000,2469000
2023,District of Oak Bay,14-5300-00,V8R 6A7,,2820 LINCOLN,1904000,1867000,220000,2087000
2023,District of Oak Bay,14-5301-00,V8R 6A7,,2800 LINCOLN,1999000,1859000,329000,2188000
2023,District of Oak Bay,14-5302-00,V8R 6A7,,2780 LINCOLN,1925000,1858000,254000,2112000
2023,District of Oak Bay,14-5303-00,V8R 6A7,,2760 LINCOLN,3866000,1956000,2226000,4182000
2023,District of Oak Bay,14-5304-00,V8R 6A1,,2765 HERON,2710000,1706000,1348000,3054000
2023,District of Oak Bay,14-5305-00,V8R 6A1,,2781 HERON,1828000,1721000,285000,2006000
2023,District of Oak Bay,14-5306-00,V8R 6A1,,2797 HERON,1752000,1721000,197000,1918000
2023,District of Oak Bay,14-5307-00,V8R 6A1,,2813 HERON,1736000,1721000,180000,1901000
2023,District of Oak Bay,14-5308-00,V8R 6A1,,2829 HERON,1760000,1724000,196000,1920000
2023,District of Oak Bay,14-5309-00,V8R 6A1,,2845 HERON,3397000,1861000,1786000,3647000
2023,District of Oak Bay,14-5310-00,V8R 6A2,,2840 HERON,1873000,1783000,271000,2054000
2023,District of Oak Bay,14-5311-00,V8R 6A2,,2820 HERON,1801000,1717000,263000,1980000
2023,District of Oak Bay,14-5312-00,V8R 6A2,,2800 HERON,1769000,1717000,220000,1937000
2023,District of Oak Bay,14-5313-00,V8R 6A2,,2786 HERON,1758000,1717000,209000,1926000
2023,District of Oak Bay,14-5314-00,V8R 6A2,,2770 HERON,3076000,1722000,1717000,3439000
2023,District of Oak Bay,14-5315-00,V8R 5Z4,,2787 DUNLEVY,1889000,1869000,198000,2067000
2023,District of Oak Bay,14-5315-00,V8R 5Z4,,2787 DUNLEVY,1889000,1869000,198000,2067000
2023,District of Oak Bay,14-5316-00,V8R 5Z4,,2807 DUNLEVY,1732000,1719000,178000,1897000
2023,District of Oak Bay,14-5317-00,V8R 5Z4,,2827 DUNLEVY,1857000,1720000,321000,2041000
2023,District of Oak Bay,14-5318-00,V8R 5Z4,,2847 DUNLEVY,2012000,1787000,422000,2209000
2023,District of Oak Bay,14-5319-00,V8R 3M8,,2617 DORSET,1686000,1664000,177000,1841000
2023,District of Oak Bay,14-5320-00,V8R 5Z5,,2830 DUNLEVY,1894000,1802000,269000,2071000
2023,District of Oak Bay,14-5321-00,V8R 5Z5,,2808 DUNLEVY,1896000,1702000,380000,2082000
2023,District of Oak Bay,14-5322-00,V8R 5Z5,,2788 DUNLEVY,1755000,1718000,206000,1924000
2023,District of Oak Bay,14-5323-00,V8R 5Y7,,2817 MUSGRAVE,1786000,1724000,230000,1954000
2023,District of Oak Bay,14-5324-00,V8R 6C6,,2527 NOTTINGHAM,2959000,1830000,1365000,3195000
2023,District of Oak Bay,14-5325-00,V8R 3M9,,2785 DORSET,1976000,1767000,397000,2164000
2023,District of Oak Bay,14-5326-00,V8R 3M9,,2771 DORSET,1817000,1767000,217000,1984000
2023,District of Oak Bay,14-5327-00,V8R 3M9,,2757 DORSET,2144000,1767000,602000,2369000
2023,District of Oak Bay,14-5328-00,V8R 3M9,,2741 DORSET,1946000,1690000,456000,2146000
2023,District of Oak Bay,14-5329-00,V8R 3M9,,2731 DORSET,2012000,1841000,383000,2224000
2023,District of Oak Bay,14-5330-00,V8Y 3G8,,2717 DORSET,1708000,1691000,179000,1870000
2023,District of Oak Bay,14-5330-00,V8R 3M9,,2717 DORSET,1708000,1691000,179000,1870000
2023,District of Oak Bay,14-5331-00,V8R 3M9,,2701 DORSET,1747000,1691000,220000,1911000
2023,District of Oak Bay,14-5332-00,V8R 3M9,,2673 DORSET,1799000,1691000,276000,1967000
2023,District of Oak Bay,14-5333-00,V8R 5Y8,,2820 MUSGRAVE,1843000,1711000,307000,2018000
2023,District of Oak Bay,14-5334-00,V6E 4P3,,2547 NOTTINGHAM,1951000,1859000,281000,2140000
2023,District of Oak Bay,14-5335-00,V8R 3N1,,2777 DOVER,1803000,1718000,264000,1982000
2023,District of Oak Bay,14-5336-00,V8R 3N2,,2761 DOVER,1807000,1718000,265000,1983000
2023,District of Oak Bay,14-5337-00,V8R 3N2,,2743 DOVER,1766000,1719000,210000,1929000
2023,District of Oak Bay,14-5338-00,V8R 3N2,,2727 DOVER,1994000,1717000,481000,2198000
2023,District of Oak Bay,14-5339-00,V8R 3N2,,2711 DOVER,1978000,1795000,384000,2179000
2023,District of Oak Bay,14-5340-00,V8R 6C9,,3014 DEVON,2128000,1866000,487000,2353000
2023,District of Oak Bay,14-5341-00,V8R 3N1,,2700 DORSET,1999000,1757000,440000,2197000
2023,District of Oak Bay,14-5342-00,V8R 3N1,,2706 DORSET,2111000,1796000,512000,2308000
2023,District of Oak Bay,14-5343-00,V8R 3N1,,2714 DORSET,1746000,1719000,199000,1918000
2023,District of Oak Bay,14-5344-00,V8R 3N1,,2730 DORSET,1836000,1718000,300000,2018000
2023,District of Oak Bay,14-5345-00,V8R 3N1,,2746 DORSET,1942000,1718000,419000,2137000
2023,District of Oak Bay,14-5346-00,V8R 3N1,,2764 DORSET,1741000,1718000,194000,1912000
2023,District of Oak Bay,14-5347-00,L9C 1C6,,2780 DORSET,2005000,1719000,474000,2193000
2023,District of Oak Bay,14-5348-00,V8R 6C7,,2541 NOTTINGHAM,1901000,1860000,221000,2081000
2023,District of Oak Bay,14-5349-00,V8R 3N1,,2666 DORSET,1974000,1757000,417000,2174000
2023,District of Oak Bay,14-5350-00,V8R 6C9,,3060 DEVON,1895000,1783000,291000,2074000
2023,District of Oak Bay,14-5351-00,V8R 6C9,,3050 DEVON,1852000,1876000,142000,2018000
2023,District of Oak Bay,14-5352-00,V8R 6C9,,3040 DEVON,2103000,1877000,433000,2310000
2023,District of Oak Bay,14-5353-00,V8R 6C9,,3030 DEVON,2275000,1958000,544000,2502000
2023,District of Oak Bay,14-5354-00,V8R 6C9,,3020 DEVON,1943000,1866000,264000,2130000
2023,District of Oak Bay,14-5355-00,V8R 3N3,,2746 DOVER,1820000,1807000,186000,1993000
2023,District of Oak Bay,14-5356-00,V8R 3N3,,2764 DOVER,1862000,1801000,224000,2025000
2023,District of Oak Bay,14-5357-00,V8R 3N3,,2780 DOVER,1839000,1801000,216000,2017000
2023,District of Oak Bay,14-5358-00,V8R 3N3,,2796 DOVER,2043000,1864000,382000,2246000
2023,District of Oak Bay,14-5359-02,V9T 6J9,, MIDLAND,1459000,1687000,0,1687000
2023,District of Oak Bay,14-5359-02,V8R 1G2,, MIDLAND,1459000,1687000,0,1687000
2023,District of Oak Bay,14-5359-03,V9T 6J9,, DORSET,121000,139000,0,139000
2023,District of Oak Bay,14-5359-03,V8R 1G2,, DORSET,121000,139000,0,139000
2023,District of Oak Bay,14-5360-00,V8S 4S3,,741 HAMPSHIRE,1359000,1287000,172000,1459000
2023,District of Oak Bay,14-5361-00,V8S 2R8,,2218 CENTRAL,1486000,1425000,196000,1621000
2023,District of Oak Bay,14-5362-00,V8S 1N7,,2190 FAIR,1404000,1283000,269000,1552000
2023,District of Oak Bay,14-5363-00,V8Y 1R1,,2442 EASTDOWNE,1397000,1356000,176000,1532000
2023,District of Oak Bay,14-5364-00,V8S 4V2,,740 MONTEREY,1549000,1418000,268000,1686000
2023,District of Oak Bay,14-5365-00,V8S 2R8,,2222 CENTRAL,1399000,1310000,187000,1497000
2023,District of Oak Bay,14-5366-00,V8S 2R8,,2230 CENTRAL,1410000,1310000,197000,1507000
2023,District of Oak Bay,14-5367-00,V8R 5V7,,1745 ST. ANN,1807000,1531000,443000,1974000
2023,District of Oak Bay,14-5369-00,V8R 6E9,,3180 MIDLAND,2651000,2828000,44000,2872000
2023,District of Oak Bay,14-5369-00,V8R 6E9,,3180 MIDLAND,2651000,2828000,44000,2872000
2023,District of Oak Bay,14-5370-00,V8R 6E5,,3215 UPPER TERRACE,2669000,2425000,407000,2832000
2023,District of Oak Bay,14-5371-00,V8R 6E5,,3205 UPPER TERRACE,2382000,2379000,186000,2565000
2023,District of Oak Bay,14-5374-00,V8S 2X7,,2031 MCNEILL,1680000,1488000,318000,1806000
2023,District of Oak Bay,14-5375-00,V8S 2X7,,2041 MCNEILL,1552000,1488000,172000,1660000
2023,District of Oak Bay,14-5376-00,V8S 2V9,,990 RUNNYMEDE,1340000,1233000,205000,1438000
2023,District of Oak Bay,14-5377-00,V8S 2V9,,976 RUNNYMEDE,1398000,1311000,190000,1501000
2023,District of Oak Bay,14-5378-00,V8S 2V9,,960 RUNNYMEDE,1390000,1325000,168000,1493000
2023,District of Oak Bay,14-5379-00,V8P 4Z2,,2190 HAULTAIN,1134000,1063000,169000,1232000
2023,District of Oak Bay,14-5380-00,V8R 5P9,,2500 EASTDOWNE,1158000,1096000,162000,1258000
2023,District of Oak Bay,14-5381-00,V8R 5P9,,2508 EASTDOWNE,1186000,1103000,185000,1288000
2023,District of Oak Bay,14-5382-00,V8R 5P9,,2516 EASTDOWNE,1178000,1115000,162000,1277000
2023,District of Oak Bay,14-5383-00,V8R 5P9,,2526 EASTDOWNE,1298000,1195000,215000,1410000
2023,District of Oak Bay,14-5384-00,V8R 5P9,,2534 EASTDOWNE,1186000,1138000,150000,1288000
2023,District of Oak Bay,14-5385-00,V8R 5P9,,2542 EASTDOWNE,1203000,1173000,135000,1308000
2023,District of Oak Bay,14-5386-00,V0N 2M0,,2552 EASTDOWNE,1291000,1231000,172000,1403000
2023,District of Oak Bay,14-5387-00,V8R 5P9,,2560 EASTDOWNE,1202000,1177000,129000,1306000
2023,District of Oak Bay,14-5388-00,V8R 5P9,,2568 EASTDOWNE,1375000,1186000,295000,1481000
2023,District of Oak Bay,14-5389-00,V8R 5P9,,2578 EASTDOWNE,1444000,1318000,260000,1578000
2023,District of Oak Bay,14-5390-00,V8R 5P9,,2586 EASTDOWNE,1257000,1158000,208000,1366000
2023,District of Oak Bay,14-5391-00,V8R 5P9,,2594 EASTDOWNE,1274000,1187000,199000,1386000
2023,District of Oak Bay,14-5392-00,V8R 5R3,,2600 EASTDOWNE,1260000,1189000,172000,1361000
2023,District of Oak Bay,14-5393-00,V8R 5R3,,2614 EASTDOWNE,1290000,1244000,157000,1401000
2023,District of Oak Bay,14-5394-00,V8R 5R3,,2628 EASTDOWNE,1324000,1244000,185000,1429000
2023,District of Oak Bay,14-5395-00,V8R 5R3,,2642 EASTDOWNE,1324000,1191000,245000,1436000
2023,District of Oak Bay,14-5396-00,V8R 5R3,,2656 EASTDOWNE,1317000,1172000,255000,1427000
2023,District of Oak Bay,14-5397-00,V8R 5R3,,2670 EASTDOWNE,2419000,1173000,1607000,2780000
2023,District of Oak Bay,14-5398-00,V8R 5R3,,2684 EASTDOWNE,1311000,1173000,248000,1421000
2023,District of Oak Bay,14-5399-00,V8R 5R3,,2698 EASTDOWNE,1208000,1167000,146000,1313000
2023,District of Oak Bay,14-5400-00,V8R 5R3,,2700 EASTDOWNE,1226000,1179000,155000,1334000
2023,District of Oak Bay,14-5401-00,V8R 5R3,,2720 EASTDOWNE,1238000,1188000,158000,1346000
2023,District of Oak Bay,14-5402-00,V8R 5R3,,2740 EASTDOWNE,1229000,1188000,150000,1338000
2023,District of Oak Bay,14-5403-00,V8R 5R3,,2760 EASTDOWNE,1243000,1188000,164000,1352000
2023,District of Oak Bay,14-5404-00,V8R 5R3,,2780 EASTDOWNE,2129000,1194000,1237000,2431000
2023,District of Oak Bay,14-5405-00,V8R 5R6,,2840 EASTDOWNE,1254000,1095000,263000,1358000
2023,District of Oak Bay,14-5406-00,V8R 5R6,,2880 EASTDOWNE,1228000,1157000,177000,1334000
2023,District of Oak Bay,14-5409-00,V8R 5S1,,2925 EASTDOWNE,1266000,1183000,194000,1377000
2023,District of Oak Bay,14-5410-00,V8R 3E5,,2251 NEIL,1329000,1253000,189000,1442000
2023,District of Oak Bay,14-5411-00,V8R 5R7,,2881 EASTDOWNE,1235000,1216000,127000,1343000
2023,District of Oak Bay,14-5412-00,V8R 5R7,,2861 EASTDOWNE,1422000,1145000,416000,1561000
2023,District of Oak Bay,14-5413-00,V8R 3C5,,2246 ALLENBY,1174000,1127000,153000,1280000
2023,District of Oak Bay,14-5414-00,V8R 3C5,,2252 ALLENBY,1291000,1149000,252000,1401000
2023,District of Oak Bay,14-5415-00,V8R 3C4,,2245 ALLENBY,1244000,1167000,183000,1350000
2023,District of Oak Bay,14-5416-00,V8R 3C4,,2235 ALLENBY,1252000,1190000,171000,1361000
2023,District of Oak Bay,14-5417-00,V8R 3C4,,2225 ALLENBY,1254000,1212000,151000,1363000
2023,District of Oak Bay,14-5418-00,V8R 5R5,,2745 EASTDOWNE,1268000,1222000,161000,1383000
2023,District of Oak Bay,14-5419-00,V8R 5R5,,2725 EASTDOWNE,1263000,1227000,146000,1373000
2023,District of Oak Bay,14-5420-00,V8R 3J1,,2228 HARLOW,1293000,1216000,189000,1405000
2023,District of Oak Bay,14-5421-00,V8R 3J1,,2238 HARLOW,1324000,1196000,238000,1434000
2023,District of Oak Bay,14-5422-00,V8R 3J1,,2248 HARLOW,1230000,1171000,166000,1337000
2023,District of Oak Bay,14-5423-00,V8R 3H9,,2245 HARLOW,1265000,1161000,211000,1372000
2023,District of Oak Bay,14-5424-00,V8R 3H9,,2235 HARLOW,1220000,1166000,159000,1325000
2023,District of Oak Bay,14-5425-00,V8R 3J1,,2225 HARLOW,1222000,1166000,156000,1322000
2023,District of Oak Bay,14-5426-00,V8R 5R4,,2695 EASTDOWNE,1363000,1159000,337000,1496000
2023,District of Oak Bay,14-5426-00,V8R 5R4,,2695 EASTDOWNE,1363000,1159000,337000,1496000
2023,District of Oak Bay,14-5427-00,V8R 5R4,,2657 EASTDOWNE,1204000,1159000,149000,1308000
2023,District of Oak Bay,14-5428-00,V8R 2V5,,2228 PACIFIC,1242000,1166000,141000,1307000
2023,District of Oak Bay,14-5429-00,V8R 2V5,,2238 PACIFIC,1251000,1166000,191000,1357000
2023,District of Oak Bay,14-5430-00,V8Z 5T7,,2248 PACIFIC,1267000,1161000,210000,1371000
2023,District of Oak Bay,14-5430-00,V8R 2V5,,2248 PACIFIC,1267000,1161000,210000,1371000
2023,District of Oak Bay,14-5432-00,V8R 2V4,,2245 PACIFIC,1347000,1167000,304000,1471000
2023,District of Oak Bay,14-5433-00,V8R 2V4,,2241 PACIFIC,1308000,1214000,202000,1416000
2023,District of Oak Bay,14-5434-00,V8R 5R2,,2631 EASTDOWNE,1529000,1417000,268000,1685000
2023,District of Oak Bay,14-5435-00,V8R 5R2,,2621 EASTDOWNE,1809000,1354000,619000,1973000
2023,District of Oak Bay,14-5435-00,V8R 5R2,,2621 EASTDOWNE,1809000,1354000,619000,1973000
2023,District of Oak Bay,14-5436-00,V8R 5R2,,2611 EASTDOWNE,1294000,1175000,226000,1401000
2023,District of Oak Bay,14-5437-00,V8R 2S3,,2244 ESTEVAN,1253000,1200000,163000,1363000
2023,District of Oak Bay,14-5438-00,V8R 2S3,,2248 ESTEVAN,1566000,1391000,302000,1693000
2023,District of Oak Bay,14-5439-00,V8R 2S3,,2252 ESTEVAN,1225000,1190000,143000,1333000
2023,District of Oak Bay,14-5441-00,V8R 2S2,,2261 ESTEVAN,1191000,1146000,148000,1294000
2023,District of Oak Bay,14-5442-00,V8R 2S2,,2255 ESTEVAN,1197000,1147000,154000,1301000
2023,District of Oak Bay,14-5443-00,V8R 2S2,,2249 ESTEVAN,1188000,1149000,142000,1291000
2023,District of Oak Bay,14-5444-00,V8R 2S2,,2243 ESTEVAN,1195000,1150000,150000,1300000
2023,District of Oak Bay,14-5445-00,V8R 2S2,,2237 ESTEVAN,1179000,1151000,128000,1279000
2023,District of Oak Bay,14-5446-00,V8R 3T2,,2231 ESTEVAN,1200000,1151000,153000,1304000
2023,District of Oak Bay,14-5447-00,V8R 5R1,,2565 EASTDOWNE,2253000,1150000,1417000,2567000
2023,District of Oak Bay,14-5448-00,V8R 5R1,,2555 EASTDOWNE,1192000,1151000,145000,1296000
2023,District of Oak Bay,14-5449-00,V8R 5R1,,2545 EASTDOWNE,1181000,1151000,132000,1283000
2023,District of Oak Bay,14-5450-00,V8R 5R1,,2535 EASTDOWNE,1264000,1126000,249000,1375000
2023,District of Oak Bay,14-5451-01,V8R 6T4,,754 MOUNTJOY,4461000,2189000,2918000,5107000
2023,District of Oak Bay,14-5451-02,V8S 4K9,,758 MOUNTJOY,3440000,2016000,1937000,3953000
2023,District of Oak Bay,14-5452-00,V8S 4K9,,776 MOUNTJOY,1597000,1772000,156000,1928000
2023,District of Oak Bay,14-5453-00,V8S 4K9,,764 MOUNTJOY,1653000,1772000,219000,1991000
2023,District of Oak Bay,14-5454-00,V8S 2W4,,2142 PENTLAND,1485000,1396000,203000,1599000
2023,District of Oak Bay,14-5455-00,V8S 2W4,,2148 PENTLAND,1611000,1469000,295000,1764000
2023,District of Oak Bay,14-5456-00,V8S 2V2,,1021 ISLAND,2282000,1436000,1068000,2504000
2023,District of Oak Bay,14-5457-05,V8S 3B6,,2453 CURRIE,1275000,1202000,168000,1370000
2023,District of Oak Bay,14-5457-10,V8S 5C4,,2463 CURRIE,1830000,1497000,518000,2015000
2023,District of Oak Bay,14-5459-00,V8S 3B6,,2473 CURRIE,2592000,1566000,1339000,2905000
2023,District of Oak Bay,14-5460-00,V8S 2Z4,,2480 MCNEILL,2345000,1548000,1627000,3175000
2023,District of Oak Bay,14-5461-00,V8S 2Z4,,2474 MCNEILL,1431000,1406000,152000,1558000
2023,District of Oak Bay,14-5462-00,V8S 5A4,,1235 TRANSIT,1491000,1438000,161000,1599000
2023,District of Oak Bay,14-5463-00,V8S 5A4,,1261 TRANSIT,1428000,1380000,169000,1549000
2023,District of Oak Bay,14-5465-00,V8R 6G1,,3185 MIDLAND,3357000,2044000,1745000,3789000
2023,District of Oak Bay,14-5466-00,V8R 6G5,,3190 RIPON,2520000,1975000,691000,2666000
2023,District of Oak Bay,14-5467-00,V8R 6G1,,3175 MIDLAND,2916000,2452000,776000,3228000
2023,District of Oak Bay,14-5467-00,V8R 6G1,,3175 MIDLAND,2916000,2452000,776000,3228000
2023,District of Oak Bay,14-5468-00,V8R 3L8,,2605 BURDICK,1945000,1789000,317000,2106000
2023,District of Oak Bay,14-5469-00,V8R 3L8,,2601 BURDICK,2548000,1544000,1347000,2891000
2023,District of Oak Bay,14-5470-00,V8S 4W3,,630 OLIVER,1612000,1572000,157000,1729000
2023,District of Oak Bay,14-5471-00,V8S 4L8,,856 FALKLAND,1578000,1494000,200000,1694000
2023,District of Oak Bay,14-5472-00,V8S 4L8,,836 FALKLAND,1568000,1494000,195000,1689000
2023,District of Oak Bay,14-5473-00,V8S 4L8,,816 FALKLAND,1710000,1494000,357000,1851000
2023,District of Oak Bay,14-5474-00,V8S 4L8,,796 FALKLAND,1608000,1514000,217000,1731000
2023,District of Oak Bay,14-5475-05,V8S 2V7,,855 RUNNYMEDE,0,1742000,0,1742000
2023,District of Oak Bay,14-5475-05,V8S 2V7,,855 RUNNYMEDE,0,1742000,0,1742000
2023,District of Oak Bay,14-5475-10,V8S 2V7,,2031 RUNNYMEDE,0,3709000,1469000,5178000
2023,District of Oak Bay,14-5476-00,V8X 2B8,,2000 LANSDOWNE,1166000,985000,241000,1226000
2023,District of Oak Bay,14-5477-00,V8P 1B3,,2016 LANSDOWNE,1270000,1110000,220000,1330000
2023,District of Oak Bay,14-5478-00,V8P 1B3,,2030 LANSDOWNE,1344000,1137000,278000,1415000
2023,District of Oak Bay,14-5479-00,V8P 1B3,,2046 LANSDOWNE,1465000,1124000,415000,1539000
2023,District of Oak Bay,14-5480-00,V8P 1B3,,2064 LANSDOWNE,1342000,1149000,247000,1396000
2023,District of Oak Bay,14-5481-00,V8P 1B3,,2080 LANSDOWNE,1377000,1186000,257000,1443000
2023,District of Oak Bay,14-5482-00,V8P 1B3,,2098 LANSDOWNE,1446000,1282000,234000,1516000
2023,District of Oak Bay,14-5483-00,V8P 1B6,,2126 LANSDOWNE,1436000,1247000,259000,1506000
2023,District of Oak Bay,14-5484-00,V8P 1B6,,2150 LANSDOWNE,1521000,1256000,346000,1602000
2023,District of Oak Bay,14-5485-00,V8P 1B6,,2176 LANSDOWNE,1438000,1256000,252000,1508000
2023,District of Oak Bay,14-5485-00,V8P 1B6,,2176 LANSDOWNE,1438000,1256000,252000,1508000
2023,District of Oak Bay,14-5486-00,V8P 1B6,,2198 LANSDOWNE,1921000,1260000,772000,2032000
2023,District of Oak Bay,14-5487-00,V8P 1B8,,2226 LANSDOWNE,1436000,1260000,242000,1502000
2023,District of Oak Bay,14-5488-00,V8P 1B8,,2244 LANSDOWNE,1467000,1201000,360000,1561000
2023,District of Oak Bay,14-5489-00,V8P 1B8,,2262 LANSDOWNE,1528000,1202000,412000,1614000
2023,District of Oak Bay,14-5490-00,V8P 1B8,,2280 LANSDOWNE,1657000,1294000,450000,1744000
2023,District of Oak Bay,14-5491-00,V8P 1B8,,2298 LANSDOWNE,1796000,1544000,346000,1890000
2023,District of Oak Bay,14-5493-00,V8P 5A3,,3123 HENDERSON,1578000,1320000,333000,1653000
2023,District of Oak Bay,14-5494-00,V8P 5A3,,3137 HENDERSON,1635000,1291000,438000,1729000
2023,District of Oak Bay,14-5495-00,V8P 5A3,,3151 HENDERSON,1535000,1260000,347000,1607000
2023,District of Oak Bay,14-5496-00,V8P 5A3,,3161 HENDERSON,1466000,1234000,299000,1533000
2023,District of Oak Bay,14-5497-00,V8P 5A3,,3171 HENDERSON,1389000,1234000,215000,1449000
2023,District of Oak Bay,14-5498-00,V8P 5A3,,3185 HENDERSON,1385000,1234000,212000,1446000
2023,District of Oak Bay,14-5499-00,V8P 5A3,,3199 HENDERSON,1332000,1234000,147000,1381000
2023,District of Oak Bay,14-5500-00,V8P 5A4,,3198 HENDERSON,1452000,1236000,280000,1516000
2023,District of Oak Bay,14-5501-00,V8P 5A4,,3182 HENDERSON,1452000,1236000,264000,1500000
2023,District of Oak Bay,14-5502-00,V8P 4Y3,,3166 WESTDOWNE,1527000,1263000,348000,1611000
2023,District of Oak Bay,14-5503-00,V8P 4Y2,,3155 WESTDOWNE,1658000,1271000,473000,1744000
2023,District of Oak Bay,14-5504-00,V8P 5A2,,3134 HENDERSON,1629000,1204000,485000,1689000
2023,District of Oak Bay,14-5505-00,V8P 5A2,,3118 HENDERSON,1386000,1204000,247000,1451000
2023,District of Oak Bay,14-5506-00,V8R 2R4,,3108 HENDERSON,1352000,1231000,177000,1408000
2023,District of Oak Bay,14-5507-00,V8P 4Y2,,3107 WESTDOWNE,1572000,1329000,324000,1653000
2023,District of Oak Bay,14-5508-00,V0R 2W1,,3133 WESTDOWNE,1347000,1155000,260000,1415000
2023,District of Oak Bay,14-5508-01,V8P 4Y2,,3145 WESTDOWNE,1383000,1066000,400000,1466000
2023,District of Oak Bay,14-5509-00,V8P 4Y3,,3158 WESTDOWNE,1900000,1641000,348000,1989000
2023,District of Oak Bay,14-5510-00,V8P 4Y3,,3148 WESTDOWNE,1856000,1655000,291000,1946000
2023,District of Oak Bay,14-5511-00,V8P 4Y3,,3138 WESTDOWNE,2281000,1447000,1010000,2457000
2023,District of Oak Bay,14-5512-00,V8P 4Y3,,3128 WESTDOWNE,1381000,1226000,218000,1444000
2023,District of Oak Bay,14-5513-00,V8P 4Y3,,3118 WESTDOWNE,1416000,1213000,268000,1481000
2023,District of Oak Bay,14-5514-00,V8P 4Y3,,3108 WESTDOWNE,1455000,1227000,304000,1531000
2023,District of Oak Bay,14-5515-00,V8S 2V9,,946 RUNNYMEDE,1694000,1618000,202000,1820000
2023,District of Oak Bay,14-5516-00,V8S 2V9,,930 RUNNYMEDE,1666000,1617000,172000,1789000
2023,District of Oak Bay,14-5517-00,V8S 2V9,,914 RUNNYMEDE,1799000,1615000,331000,1946000
2023,District of Oak Bay,14-5518-00,V8S 2V9,,900 RUNNYMEDE,1711000,1614000,227000,1841000
2023,District of Oak Bay,14-5519-00,V8S 2V9,,884 RUNNYMEDE,1689000,1613000,194000,1807000
2023,District of Oak Bay,14-5520-00,V8S 2V6,,2004 RUNNYMEDE,1260000,1053000,330000,1383000
2023,District of Oak Bay,14-5524-00,V8R 3L9,,2425 DRYFE,1349000,1240000,251000,1491000
2023,District of Oak Bay,14-5526-00,V8R 5S1,,2937 EASTDOWNE,1235000,1095000,190000,1285000
2023,District of Oak Bay,15-5529-00,V8R 5M4,,2919 HENDERSON,1367000,1297000,180000,1477000
2023,District of Oak Bay,15-5530-00,V8R 3E4,,2106 NEIL,1310000,1270000,152000,1422000
2023,District of Oak Bay,15-5531-00,V8R 3E4,,2114 NEIL,2467000,1311000,1494000,2805000
2023,District of Oak Bay,15-5531-00,V8R 4N5,,2114 NEIL,2467000,1311000,1494000,2805000
2023,District of Oak Bay,15-5532-00,V8R 3E4,,2120 NEIL,1401000,1305000,204000,1509000
2023,District of Oak Bay,15-5533-00,V8R 3E4,,2128 NEIL,1699000,1326000,564000,1890000
2023,District of Oak Bay,15-5534-00,V0R 2Z0,,2134 NEIL,1314000,1266000,162000,1428000
2023,District of Oak Bay,15-5535-00,V8R 3E4,,2142 NEIL,1352000,1261000,174000,1435000
2023,District of Oak Bay,15-5536-00,V8R 3E4,,2148 NEIL,1322000,1257000,179000,1436000
2023,District of Oak Bay,15-5537-00,V8R 3E4,,2156 NEIL,1380000,1249000,233000,1482000
2023,District of Oak Bay,15-5538-00,V8R 3E4,,2162 NEIL,2602000,1243000,1690000,2933000
2023,District of Oak Bay,15-5539-00,V8R 3E4,,2170 NEIL,1513000,1237000,423000,1660000
2023,District of Oak Bay,15-5540-00,V8R 3E4,,2176 NEIL,1327000,1231000,211000,1442000
2023,District of Oak Bay,15-5541-00,V8R 3E4,,2184 NEIL,1265000,1225000,151000,1376000
2023,District of Oak Bay,15-5542-00,V9R 3E4,,2190 NEIL,1269000,1219000,159000,1378000
2023,District of Oak Bay,15-5544-00,V8R 3E3,,2199 NEIL,1210000,1136000,178000,1314000
2023,District of Oak Bay,15-5545-00,V8R 3E3,,2189 NEIL,1262000,1138000,240000,1378000
2023,District of Oak Bay,15-5546-00,V8R 3E3,,2181 NEIL,1311000,1143000,277000,1420000
2023,District of Oak Bay,15-5547-00,V8R 3E3,,2173 NEIL,1195000,1147000,152000,1299000
2023,District of Oak Bay,15-5548-00,V8R 3E3,,2167 NEIL,1252000,1151000,207000,1358000
2023,District of Oak Bay,15-5549-00,V8R 3E3,,2159 NEIL,1315000,1156000,273000,1429000
2023,District of Oak Bay,15-5549-00,,,2159 NEIL,1315000,1156000,273000,1429000
2023,District of Oak Bay,15-5550-00,V8R 3E3,,2151 NEIL,1287000,1160000,230000,1390000
2023,District of Oak Bay,15-5551-00,V8R 3E3,,2141 NEIL,1237000,1169000,175000,1344000
2023,District of Oak Bay,15-5552-00,V8R 3E3,,2133 NEIL,1221000,1166000,161000,1327000
2023,District of Oak Bay,15-5553-00,V8R 3E3,,2125 NEIL,1237000,1174000,171000,1345000
2023,District of Oak Bay,15-5554-00,V8R 3E3,,2117 NEIL,1416000,1164000,372000,1536000
2023,District of Oak Bay,15-5555-00,V8R 3E3,,2109 NEIL,1280000,1168000,223000,1391000
2023,District of Oak Bay,15-5556-00,V8P 1B3,,2101 NEIL,1200000,1159000,145000,1304000
2023,District of Oak Bay,15-5557-00,V8X 0A6,,2100 ALLENBY,1185000,1146000,142000,1288000
2023,District of Oak Bay,15-5558-00,V8R 3C3,,2108 ALLENBY,1213000,1151000,167000,1318000
2023,District of Oak Bay,15-5559-00,,,2118 ALLENBY,1259000,1147000,220000,1367000
2023,District of Oak Bay,15-5559-00,V8R 3C3,,2118 ALLENBY,1259000,1147000,220000,1367000
2023,District of Oak Bay,15-5560-00,V8R 3C3,,2126 ALLENBY,1231000,1158000,177000,1335000
2023,District of Oak Bay,15-5561-00,V8R 3C3,,2136 ALLENBY,1226000,1163000,161000,1324000
2023,District of Oak Bay,15-5561-00,V8R 3C3,,2136 ALLENBY,1226000,1163000,161000,1324000
2023,District of Oak Bay,15-5562-00,V8R 3C3,,2144 ALLENBY,1352000,1174000,279000,1453000
2023,District of Oak Bay,15-5563-00,V2R 0G7,,2154 ALLENBY,1237000,1162000,176000,1338000
2023,District of Oak Bay,15-5564-00,V8R 3C3,,2162 ALLENBY,1243000,1157000,191000,1348000
2023,District of Oak Bay,15-5565-00,V8R 3C3,,2172 ALLENBY,1209000,1153000,160000,1313000
2023,District of Oak Bay,15-5566-00,V8R 3C3,,2180 ALLENBY,1183000,1148000,137000,1285000
2023,District of Oak Bay,15-5567-00,V8R 3C3,,2190 ALLENBY,1350000,1144000,312000,1456000
2023,District of Oak Bay,15-5568-00,V8R 3C3,,2198 ALLENBY,1366000,1238000,247000,1485000
2023,District of Oak Bay,15-5569-00,V8R 3C2,,2199 ALLENBY,1322000,1177000,410000,1587000
2023,District of Oak Bay,15-5570-00,V8R 3C2,,2191 ALLENBY,1198000,1162000,140000,1302000
2023,District of Oak Bay,15-5571-00,V8R 3C2,,2181 ALLENBY,1210000,1163000,153000,1316000
2023,District of Oak Bay,15-5571-00,V8R 3C2,,2181 ALLENBY,1210000,1163000,153000,1316000
2023,District of Oak Bay,15-5572-00,V8R 3C2,,2171 ALLENBY,1487000,1162000,448000,1610000
2023,District of Oak Bay,15-5573-00,V8R 3C2,,2161 ALLENBY,1303000,1162000,256000,1418000
2023,District of Oak Bay,15-5574-00,V8R 3C2,,2151 ALLENBY,1782000,1120000,849000,1969000
2023,District of Oak Bay,15-5575-00,V8R 3C2,,2141 ALLENBY,1183000,1120000,169000,1289000
2023,District of Oak Bay,15-5576-00,V8R 3C2,,2131 ALLENBY,1208000,1162000,150000,1312000
2023,District of Oak Bay,15-5577-00,V8R 3C2,,2121 ALLENBY,1235000,1162000,179000,1341000
2023,District of Oak Bay,15-5578-00,V8R 3C2,,2111 ALLENBY,1243000,1162000,188000,1350000
2023,District of Oak Bay,15-5579-00,V8R 3C2,,2101 ALLENBY,1187000,1146000,142000,1288000
2023,District of Oak Bay,15-5580-00,V8R 2S1,,2100 NEWTON,1232000,1177000,155000,1332000
2023,District of Oak Bay,15-5581-00,V8R 2S1,,2110 NEWTON,1335000,1156000,302000,1458000
2023,District of Oak Bay,15-5582-00,V8R 2S1,,2120 NEWTON,1221000,1156000,170000,1326000
2023,District of Oak Bay,15-5583-00,V8R 2S1,,2130 NEWTON,1215000,1156000,162000,1318000
2023,District of Oak Bay,15-5584-00,V8R 2S1,,2140 NEWTON,1169000,1113000,150000,1263000
2023,District of Oak Bay,15-5585-00,V8R 2S1,,2150 NEWTON,1158000,1113000,142000,1255000
2023,District of Oak Bay,15-5586-00,V8R 2S1,,2160 NEWTON,1188000,1156000,135000,1291000
2023,District of Oak Bay,15-5587-00,V8R 2S1,,2170 NEWTON,1213000,1156000,160000,1316000
2023,District of Oak Bay,15-5588-00,V8R 2S1,,2180 NEWTON,1353000,1220000,237000,1457000
2023,District of Oak Bay,15-5589-00,V8R 2R9,,2181 NEWTON,1213000,1163000,155000,1318000
2023,District of Oak Bay,15-5590-00,V8R 2R9,,2171 NEWTON,1321000,1163000,268000,1431000
2023,District of Oak Bay,15-5591-00,V8R 2R9,,2161 NEWTON,1209000,1172000,147000,1319000
2023,District of Oak Bay,15-5592-00,V8R 2R9,,2151 NEWTON,1215000,1174000,146000,1320000
2023,District of Oak Bay,15-5593-00,V8R 2R9,,2141 NEWTON,1277000,1174000,213000,1387000
2023,District of Oak Bay,15-5594-00,V8R 2R9,,2131 NEWTON,1225000,1173000,159000,1332000
2023,District of Oak Bay,15-5595-00,V8R 2R9,,2121 NEWTON,1236000,1173000,171000,1344000
2023,District of Oak Bay,15-5596-00,V8R 2R9,,2111 NEWTON,1177000,1131000,148000,1279000
2023,District of Oak Bay,15-5597-00,V8R 5M1,,2721 HENDERSON,1191000,1129000,170000,1299000
2023,District of Oak Bay,15-5598-00,V8R 1G2,,2801 HENDERSON,9988000,9528000,494000,10022000
2023,District of Oak Bay,15-5598-01,V8R 1G2,, HENDERSON,989000,957000,169000,1126000
2023,District of Oak Bay,15-5598-01,V8R 1G2,, HENDERSON,989000,957000,169000,1126000
2023,District of Oak Bay,15-5599-00,V8R 5X2,,1596 YORK,1812000,1824000,155000,1979000
2023,District of Oak Bay,15-5600-00,V8R 2V4,,2249 PACIFIC,1307000,1248000,174000,1422000
2023,District of Oak Bay,15-5601-00,V8R 2V4,,2255 PACIFIC,1903000,1210000,826000,2036000
2023,District of Oak Bay,15-5602-00,V8R 2S3,,2256 ESTEVAN,1387000,1252000,270000,1522000
2023,District of Oak Bay,15-5602-00,V8R 2S3,,2256 ESTEVAN,1387000,1252000,270000,1522000
2023,District of Oak Bay,15-5603-00,V8R 2S3,,2260 ESTEVAN,1558000,1274000,426000,1700000
2023,District of Oak Bay,15-5606-00,V8S 4K5,, DENISON,318000,387000,0,387000
2023,District of Oak Bay,15-5607-00,V8P 5C4,,3600 CRESTVIEW,1580000,1310000,333000,1643000
2023,District of Oak Bay,15-5608-00,V8P 5C4,,3608 CRESTVIEW,1539000,1392000,206000,1598000
2023,District of Oak Bay,15-5609-00,V8P 5C4,,3616 CRESTVIEW,1540000,1392000,224000,1616000
2023,District of Oak Bay,15-5610-00,V8P 5C4,,3624 CRESTVIEW,1469000,1372000,158000,1530000
2023,District of Oak Bay,15-5611-00,V8P 5C4,,3632 CRESTVIEW,1446000,1337000,163000,1500000
2023,District of Oak Bay,15-5612-00,V8P 5C4,,3640 CRESTVIEW,1417000,1328000,145000,1473000
2023,District of Oak Bay,15-5613-00,V8P 5C4,,3648 CRESTVIEW,1812000,1337000,563000,1900000
2023,District of Oak Bay,15-5614-00,V8P 5C4,,3656 CRESTVIEW,1425000,1326000,145000,1471000
2023,District of Oak Bay,15-5615-00,V8P 5C4,,3664 CRESTVIEW,1439000,1323000,174000,1497000
2023,District of Oak Bay,15-5616-00,V8P 5C4,,3672 CRESTVIEW,2550000,1339000,1513000,2852000
2023,District of Oak Bay,15-5617-00,V8P 5C4,,3680 CRESTVIEW,1450000,1380000,118000,1498000
2023,District of Oak Bay,15-5618-00,V8P 5C4,,3688 CRESTVIEW,1696000,1558000,204000,1762000
2023,District of Oak Bay,15-5619-00,V8P 5C4,,3696 CRESTVIEW,1716000,1583000,206000,1789000
2023,District of Oak Bay,15-5620-00,V8P 5C5,,3699 CRESTVIEW,2349000,2135000,298000,2433000
2023,District of Oak Bay,15-5621-00,V8E 0W2,,3689 CRESTVIEW,2386000,2159000,320000,2479000
2023,District of Oak Bay,15-5621-00,V8P 5C5,,3689 CRESTVIEW,2386000,2159000,320000,2479000
2023,District of Oak Bay,15-5621-00,V8P 5C5,,3689 CRESTVIEW,2386000,2159000,320000,2479000
2023,District of Oak Bay,15-5622-00,V8P 5C5,,3681 CRESTVIEW,2210000,2037000,267000,2304000
2023,District of Oak Bay,15-5623-00,V8P 5C5,,3671 CRESTVIEW,3275000,1883000,1684000,3567000
2023,District of Oak Bay,15-5624-00,V8P 5C5,,3661 CRESTVIEW,2288000,1822000,598000,2420000
2023,District of Oak Bay,15-5625-00,,,3651 CRESTVIEW,1746000,1515000,301000,1816000
2023,District of Oak Bay,15-5626-00,V8P 5C5,,3641 CRESTVIEW,1586000,1419000,223000,1642000
2023,District of Oak Bay,15-5627-00,V8P 5C5,,3631 CRESTVIEW,1485000,1393000,149000,1542000
2023,District of Oak Bay,15-5628-00,V8P 5C5,,3621 CRESTVIEW,1545000,1392000,210000,1602000
2023,District of Oak Bay,15-5629-00,V8P 5C5,,3611 CRESTVIEW,1484000,1392000,141000,1533000
2023,District of Oak Bay,15-5630-00,V8P 5C5,,3601 CRESTVIEW,2984000,1374000,2003000,3377000
2023,District of Oak Bay,15-5631-00,V8R 5G6,,2080 CADBORO BAY,1090000,994000,210000,1204000
2023,District of Oak Bay,15-5632-00,V8N 6N3,,2090 CADBORO BAY,1031000,983000,155000,1138000
2023,District of Oak Bay,15-5636-00,V8S 2X8,,2050 MCNEILL,1467000,1356000,219000,1575000
2023,District of Oak Bay,15-5637-00,V8S 2X8,,2060 MCNEILL,1406000,1363000,148000,1511000
2023,District of Oak Bay,15-5638-00,V8S 2X8,,2070 MCNEILL,1483000,1357000,231000,1588000
2023,District of Oak Bay,15-5639-00,K1Y 3E8,,2080 MCNEILL,1532000,1385000,265000,1650000
2023,District of Oak Bay,15-5639-02,V8S 4J7,,2020 ROMNEY,275000,335000,0,335000
2023,District of Oak Bay,15-5640-00,V8S 2N1,,1399 VICTORIA,1401000,1345000,162000,1507000
2023,District of Oak Bay,15-5641-00,V8S 2N1,,2135 GRANITE,1713000,1664000,192000,1856000
2023,District of Oak Bay,15-5644-00,V6E 4M3,,2181 HAULTAIN,10843000,4962000,6970000,11932000
2023,District of Oak Bay,15-5644-00,V6E 4M3,,2181 HAULTAIN,10843000,4962000,6970000,11932000
2023,District of Oak Bay,15-5644-00,V6E 4M3,,2181 HAULTAIN,10843000,4962000,6970000,11932000
2023,District of Oak Bay,15-5644-00,V6E 4M3,,2181 HAULTAIN,10843000,4962000,6970000,11932000
2023,District of Oak Bay,15-5644-00,V6E 4M3,,2181 HAULTAIN,10843000,4962000,6970000,11932000
2023,District of Oak Bay,15-5644-00,V6E 4M3,,2181 HAULTAIN,10843000,4962000,6970000,11932000
2023,District of Oak Bay,15-5650-00,V8V 3K2,,2150 HAULTAIN,3058000,2078000,1293000,3371000
2023,District of Oak Bay,15-5650-00,V8V 3K2,,2150 HAULTAIN,3058000,2078000,1293000,3371000
2023,District of Oak Bay,15-5651-00,V8P 3C8,,2160 HAULTAIN,1908500,1877000,223000,2100000
2023,District of Oak Bay,15-5652-00,V8R 1R6,,2170 HAULTAIN,2449000,1815000,883000,2698000
2023,District of Oak Bay,15-5653-00,V3L 1R3,,2180 HAULTAIN,2929000,1803000,1421000,3224000
2023,District of Oak Bay,15-5654-00,V5P 1J7,,2501 WOOTTON,1156000,1127000,123000,1250000
2023,District of Oak Bay,15-5655-00,V8P 5P9,,2507 WOOTTON,2374000,1215000,1496000,2711000
2023,District of Oak Bay,15-5655-00,V8P 5P9,,2507 WOOTTON,2374000,1215000,1496000,2711000
2023,District of Oak Bay,15-5656-00,V8R 5M7,,2513 WOOTTON,1283000,1200000,190000,1390000
2023,District of Oak Bay,15-5657-00,V8R 5M7,,2519 WOOTTON,1305000,1165000,257000,1422000
2023,District of Oak Bay,15-5658-00,V8R 5M7,,2525 WOOTTON,1191000,1147000,146000,1293000
2023,District of Oak Bay,15-5659-00,V9Z 1C2,,2531 WOOTTON,1193000,1144000,151000,1295000
2023,District of Oak Bay,15-5660-00,V8R 5M7,,2537 WOOTTON,1264000,1127000,246000,1373000
2023,District of Oak Bay,15-5661-00,V8R 5M7,,2543 WOOTTON,1189000,1136000,158000,1294000
2023,District of Oak Bay,15-5662-00,V8R 5M7,,2549 WOOTTON,1240000,1147000,199000,1346000
2023,District of Oak Bay,15-5663-00,V8R 5M7,,2555 WOOTTON,1273000,1234000,150000,1384000
2023,District of Oak Bay,15-5664-00,V8R 2P9,,2150 KINGS,1547000,1395000,288000,1683000
2023,District of Oak Bay,15-5665-00,V8R 2P9,,2140 KINGS,1396000,1268000,242000,1510000
2023,District of Oak Bay,15-5666-00,V8R 2P9,,2130 KINGS,1305000,1234000,183000,1417000
2023,District of Oak Bay,15-5667-00,V8R 2P9,,2120 KINGS,1385000,1230000,282000,1512000
2023,District of Oak Bay,15-5668-00,V4B 3A3,,2110 KINGS,1306000,1230000,178000,1408000
2023,District of Oak Bay,15-5669-00,V8R 2P9,,2100 KINGS,1292000,1242000,166000,1408000
2023,District of Oak Bay,15-5670-00,V8R 2P8,,2101 KINGS,1350000,1325000,140000,1465000
2023,District of Oak Bay,15-5671-00,V8R 2P8,,2111 KINGS,1407000,1211000,331000,1542000
2023,District of Oak Bay,15-5672-00,V8R 2P8,,2121 KINGS,1308000,1204000,220000,1424000
2023,District of Oak Bay,15-5673-00,T3Z 3K8,,2536 WOOTTON,1403000,1280000,242000,1522000
2023,District of Oak Bay,15-5674-00,V8R 5M8,,2520 WOOTTON,1760000,1323000,626000,1949000
2023,District of Oak Bay,15-5675-00,V8R 5M8,,2506 WOOTTON,1430000,1328000,248000,1576000
2023,District of Oak Bay,15-5676-00,V8S 4J1,,1010 FOUL BAY,1488000,1176000,458000,1634000
2023,District of Oak Bay,15-5677-00,V8S 4J1,,1002 FOUL BAY,1308000,1225000,182000,1407000
2023,District of Oak Bay,15-5678-00,V8S 3G2,,1991 GRANITE,1353000,1184000,285000,1469000
2023,District of Oak Bay,15-5679-00,V9A 2S5,,2040 MCNEILL,1488000,1437000,160000,1597000
2023,District of Oak Bay,15-5682-00,V8R 6L5,,3065 BEACH,2828000,2727000,305000,3032000
2023,District of Oak Bay,15-5683-00,V8R 6L5,,3055 BEACH,2647000,2503000,316000,2819000
2023,District of Oak Bay,15-5689-00,V8S 5A3,,1390 TRANSIT,1279000,1101000,286000,1387000
2023,District of Oak Bay,15-5690-00,V8R 6C5,,2805 BEACH,2980000,2731000,422000,3153000
2023,District of Oak Bay,15-5690-00,V8R 6K8,,2805 BEACH,2980000,2731000,422000,3153000
2023,District of Oak Bay,15-5692-00,V8S 4X9,,985 ST. PATRICK,1647000,1469000,320000,1789000
2023,District of Oak Bay,15-5693-00,V8S 2Z2,,2359 MCNEILL,1213000,1159000,142000,1301000
2023,District of Oak Bay,15-5694-00,V8S 5C4,,16 KING GEORGE,1665000,1761000,246000,2007000
2023,District of Oak Bay,15-5694-01,V8R 1G2,, KING GEORGE,24300,27900,0,27900
2023,District of Oak Bay,15-5696-00,V8S 4H8,,930 FOUL BAY,1094000,862000,309000,1171000
2023,District of Oak Bay,15-5698-00,V8R 6B7,,3220 UPLANDS,2686000,2603000,271000,2874000
2023,District of Oak Bay,15-5699-00,V8R 3S5,,3240 UPLANDS,5534000,2572000,3216000,5788000
2023,District of Oak Bay,15-5700-00,V8R 3S5,,3260 UPLANDS,2520800,2658000,63300,2721300
2023,District of Oak Bay,15-5701-00,V8R 6B9,,3280 UPLANDS,5189000,2648000,2929000,5577000
2023,District of Oak Bay,15-5702-00,V8P 5A8,,3403 HENDERSON,1328000,1171000,207000,1378000
2023,District of Oak Bay,15-5703-00,V8P 5A8,,3393 HENDERSON,1297000,1171000,177000,1348000
2023,District of Oak Bay,15-5704-00,V8P 5A8,,3383 HENDERSON,1300000,1171000,180000,1351000
2023,District of Oak Bay,15-5705-00,V8P 5A8,,3373 HENDERSON,1366000,1171000,247000,1418000
2023,District of Oak Bay,15-5706-00,V8P 5A8,,3363 HENDERSON,1288000,1171000,165000,1336000
2023,District of Oak Bay,15-5706-00,V8P 5A8,,3363 HENDERSON,1288000,1171000,165000,1336000
2023,District of Oak Bay,15-5707-00,V8P 5A8,,3353 HENDERSON,1323000,1171000,197000,1368000
2023,District of Oak Bay,15-5708-00,V8P 5A8,,3343 HENDERSON,1343000,1169000,226000,1395000
2023,District of Oak Bay,15-5709-00,V8P 5A5,,3333 HENDERSON,1302000,1110000,229000,1339000
2023,District of Oak Bay,15-5710-00,V8P 5A5,,3323 HENDERSON,1244000,1112000,182000,1294000
2023,District of Oak Bay,15-5711-00,V8P 5A5,,3315 HENDERSON,1299000,1112000,227000,1339000
2023,District of Oak Bay,15-5712-00,V8P 5A5,,3303 HENDERSON,1370000,1177000,260000,1437000
2023,District of Oak Bay,15-5713-00,V8P 5A5,,3293 HENDERSON,1317000,1203000,162000,1365000
2023,District of Oak Bay,15-5714-00,V8P 5A5,,3283 HENDERSON,2342000,1229000,1369000,2598000
2023,District of Oak Bay,15-5715-00,V8P 5A5,,3273 HENDERSON,1319000,1212000,158000,1370000
2023,District of Oak Bay,15-5716-00,V8P 5A5,,3263 HENDERSON,1700000,1249000,564000,1813000
2023,District of Oak Bay,15-5717-00,V8P 5A5,,3253 HENDERSON,1414000,1250000,232000,1482000
2023,District of Oak Bay,15-5718-00,V8P 5A5,,3243 HENDERSON,1463000,1243000,294000,1537000
2023,District of Oak Bay,15-5719-00,V8P 1E8,,2226 WESSEX,1719000,1227000,613000,1840000
2023,District of Oak Bay,15-5720-00,V8P 5A3,,3223 HENDERSON,1583000,1390000,268000,1658000
2023,District of Oak Bay,15-5721-00,V8P 5A3,,3215 HENDERSON,2042000,1265000,932000,2197000
2023,District of Oak Bay,15-5722-00,V8P 5A4,,3214 HENDERSON,1458000,1239000,278000,1517000
2023,District of Oak Bay,15-5723-00,V8P 5A4,,3230 HENDERSON,1564000,1296000,348000,1644000
2023,District of Oak Bay,15-5724-00,V8P 5A6,,3246 HENDERSON,1431000,1262000,230000,1492000
2023,District of Oak Bay,15-5725-00,V8P 5A6,,3262 HENDERSON,1458000,1293000,231000,1524000
2023,District of Oak Bay,15-5726-00,V8P 5A6,,3278 HENDERSON,1406000,1292000,168000,1460000
2023,District of Oak Bay,15-5727-00,V5B 4A4,,3294 HENDERSON,1467000,1302000,233000,1535000
2023,District of Oak Bay,15-5728-00,V8R 5N4,,3306 HENDERSON,1236000,1036000,247000,1283000
2023,District of Oak Bay,15-5729-00,V8P 5A7,,3312 HENDERSON,1148000,1037000,150000,1187000
2023,District of Oak Bay,15-5730-00,V8P 5A7,,3322 HENDERSON,1278000,1036000,306000,1342000
2023,District of Oak Bay,15-5731-00,V8W 3Z2,,3332 HENDERSON,1242000,1116000,174000,1290000
2023,District of Oak Bay,15-5732-00,V8P 5A7,,3342 HENDERSON,1305000,1124000,233000,1357000
2023,District of Oak Bay,15-5733-00,V8P 5A7,,3352 HENDERSON,1319000,1124000,250000,1374000
2023,District of Oak Bay,15-5734-00,V8P 5A7,,3362 HENDERSON,1452000,1124000,414000,1538000
2023,District of Oak Bay,15-5735-00,V8P 5A7,,3372 HENDERSON,1363000,1124000,312000,1436000
2023,District of Oak Bay,15-5736-00,V8R 6G1,,3382 HENDERSON,1241000,1124000,170000,1294000
2023,District of Oak Bay,15-5737-00,V8P 5A7,,3392 HENDERSON,1324000,1124000,252000,1376000
2023,District of Oak Bay,15-5738-00,V8P 5A7,,3402 HENDERSON,1331000,1124000,265000,1389000
2023,District of Oak Bay,15-5739-00,V8R 6M5,,3498 BEACH,3112000,3127000,219000,3346000
2023,District of Oak Bay,15-5740-00,V8R 6M5,,3490 BEACH,3490000,3051000,564000,3615000
2023,District of Oak Bay,15-5741-00,V8R 6G3,,3465 MIDLAND,4200000,2807000,1948000,4755000
2023,District of Oak Bay,15-5742-00,V8R 6M5,,3460 BEACH,3542000,3570000,236000,3806000
2023,District of Oak Bay,15-5743-00,V8R 6G3,,3435 MIDLAND,2949000,2815000,338000,3153000
2023,District of Oak Bay,15-5744-00,V8R 6G3,,3405 MIDLAND,5412000,3222000,2725000,5947000
2023,District of Oak Bay,15-5745-00,V8R 6G3,,3375 MIDLAND,3546000,3247000,530000,3777000
2023,District of Oak Bay,15-5745-00,V8R 6G3,,3375 MIDLAND,3546000,3247000,530000,3777000
2023,District of Oak Bay,15-5746-00,T6M 2V2,,3355 MIDLAND,8113000,3183000,5362000,8545000
2023,District of Oak Bay,15-5747-00,V8R 6G3,,3335 MIDLAND,5742000,3144000,3007000,6151000
2023,District of Oak Bay,15-5748-00,V8R 6G3,,3315 MIDLAND,2858100,3059000,34700,3093700
2023,District of Oak Bay,15-5749-00,V8R 6G3,,3295 MIDLAND,4447000,2919000,1874000,4793000
2023,District of Oak Bay,15-5750-00,V8R 6G3,,3265 MIDLAND,2640900,2809000,47300,2856300
2023,District of Oak Bay,15-5751-00,V8R 6G3,,3215 MIDLAND,2430000,2372000,241000,2613000
2023,District of Oak Bay,15-5752-00,V8R 6G7,,3210 RIPON,2346100,2495000,36000,2531000
2023,District of Oak Bay,15-5753-00,V8N 4A6,,2100 CADBORO BAY,3463700,3411000,403000,3814000
2023,District of Oak Bay,15-5754-00,V9C 4A7,,2140 CADBORO BAY,9044000,5680000,4287000,9967000
2023,District of Oak Bay,15-5755-00,V8S 4S3,,797 HAMPSHIRE,1404000,1335000,172000,1507000
2023,District of Oak Bay,15-5756-00,V8N 6A7,,824 MONTEREY,1367000,1299000,128000,1427000
2023,District of Oak Bay,15-5757-00,V8S 4S3,,785 HAMPSHIRE,2123000,1315000,1059000,2374000
2023,District of Oak Bay,15-5758-00,V8S 4V2,,812 MONTEREY,1771000,1539000,388000,1927000
2023,District of Oak Bay,15-5758-00,V8S 4V2,,812 MONTEREY,1771000,1539000,388000,1927000
2023,District of Oak Bay,15-5759-00,V8M 2C3,,2073 OAK BAY,3160000,2159000,1316000,3475000
2023,District of Oak Bay,15-5761-00,V8S 2Z7,,2070 STONEHEWER,1663000,1457000,340000,1797000
2023,District of Oak Bay,15-5762-00,V8S 2Z7,,2090 STONEHEWER,1710000,1473000,363000,1836000
2023,District of Oak Bay,15-5763-00,V8S 4M4,,1054 FALKLAND,1360000,1320000,152000,1472000
2023,District of Oak Bay,15-5764-00,V8S 2Z7,,2098 STONEHEWER,1465000,1320000,259000,1579000
2023,District of Oak Bay,15-5767-00,V8R 6K2,,2305 DUNLEVY,1670000,1592000,239000,1831000
2023,District of Oak Bay,15-5767-00,V8R 5Z1,,2305 DUNLEVY,1670000,1592000,239000,1831000
2023,District of Oak Bay,15-5768-00,V8R 5Z1,,2295 DUNLEVY,1731000,1632000,248000,1880000
2023,District of Oak Bay,15-5769-00,V8R 1R6,,2646 SHADY,1768000,1733000,199000,1932000
2023,District of Oak Bay,15-5770-00,V8R 1R6,,2660 SHADY,1809000,1734000,234000,1968000
2023,District of Oak Bay,15-5770-00,V8R 1R6,,2660 SHADY,1809000,1734000,234000,1968000
2023,District of Oak Bay,15-5771-00,V8R 6J2,,1762 BEACH,3052000,1918000,1535000,3453000
2023,District of Oak Bay,15-5772-00,V8P 5B8,,3391 WOODBURN,1816000,1694000,196000,1890000
2023,District of Oak Bay,15-5773-00,V8P 5B8,,3381 WOODBURN,2061000,1646000,542000,2188000
2023,District of Oak Bay,15-5774-00,V8Y 3C4,,3371 WOODBURN,1765000,1665000,155000,1820000
2023,District of Oak Bay,15-5775-00,V8P 5B8,,3361 WOODBURN,2198000,1681000,597000,2278000
2023,District of Oak Bay,15-5776-00,V8P 5B8,,3351 WOODBURN,1953000,1689000,362000,2051000
2023,District of Oak Bay,15-5777-00,V8P 5B8,,3341 WOODBURN,1884000,1696000,269000,1965000
2023,District of Oak Bay,15-5778-00,V8P 5B8,,3331 WOODBURN,2344000,1689000,848000,2537000
2023,District of Oak Bay,15-5779-00,V8P 5B8,,3321 WOODBURN,1813000,1667000,227000,1894000
2023,District of Oak Bay,15-5780-00,V8P 5B8,,3311 WOODBURN,3162000,1645000,1842000,3487000
2023,District of Oak Bay,15-5781-00,V8P 5B8,,3301 WOODBURN,1928000,1622000,407000,2029000
2023,District of Oak Bay,15-5782-00,V8P 5B8,,3291 WOODBURN,2135000,1618000,659000,2277000
2023,District of Oak Bay,15-5783-00,V8P 5B8,,3281 WOODBURN,1911000,1632000,356000,1988000
2023,District of Oak Bay,15-5784-00,V8P 5B8,,3271 WOODBURN,3137000,1728000,1763000,3491000
2023,District of Oak Bay,15-5785-00,V8P 5B8,,3261 WOODBURN,2055000,1740000,410000,2150000
2023,District of Oak Bay,15-5786-00,V8P 5B8,,3245 WOODBURN,2300000,1759000,701000,2460000
2023,District of Oak Bay,15-5787-00,V8P 5B8,,3231 WOODBURN,2709000,1776000,1213000,2989000
2023,District of Oak Bay,15-5788-00,V8P 5B8,,3219 WOODBURN,2514000,1833000,844000,2677000
2023,District of Oak Bay,15-5789-00,V8P 5B8,,3191 WOODBURN,1944000,1840000,184000,2024000
2023,District of Oak Bay,15-5789-00,V0N 2M1,,3191 WOODBURN,1944000,1840000,184000,2024000
2023,District of Oak Bay,15-5790-00,V8P 5B8,,3181 WOODBURN,2200000,1814000,515000,2329000
2023,District of Oak Bay,15-5791-00,V8P 5B8,,3171 WOODBURN,2121000,1741000,487000,2228000
2023,District of Oak Bay,15-5792-00,V8P 5B8,,3141 WOODBURN,1556000,1339000,287000,1626000
2023,District of Oak Bay,15-5792-01,V8P 5B8,,3131 WOODBURN,1419000,1210000,279000,1489000
2023,District of Oak Bay,15-5793-00,V8P 5B8,,3111 WOODBURN,1425000,1125000,385000,1510000
2023,District of Oak Bay,15-5793-01,V8P 5B8,,3121 WOODBURN,1402000,1184000,290000,1474000
2023,District of Oak Bay,15-5794-00,V8P 5B7,,3100 WOODBURN,1304000,1234000,117000,1351000
2023,District of Oak Bay,15-5795-00,V8P 5B7,,3114 WOODBURN,1502000,1253000,328000,1581000
2023,District of Oak Bay,15-5796-00,V8P 5B7,,3128 WOODBURN,1568000,1263000,384000,1647000
2023,District of Oak Bay,15-5797-00,V8P 5B7,,3142 WOODBURN,1418000,1272000,212000,1484000
2023,District of Oak Bay,15-5798-00,V8P 5B7,,3156 WOODBURN,2179000,1252000,1165000,2417000
2023,District of Oak Bay,15-5799-00,V8P 5B7,,3170 WOODBURN,1550000,1214000,431000,1645000
2023,District of Oak Bay,15-5800-00,V8P 5B7,,3184 WOODBURN,1517000,1200000,407000,1607000
2023,District of Oak Bay,15-5801-00,V8P 5B7,,3198 WOODBURN,1379000,1217000,226000,1443000
2023,District of Oak Bay,15-5802-00,V8P 5B7,,3210 WOODBURN,1542000,1244000,386000,1630000
2023,District of Oak Bay,15-5803-00,V8P 5B7,,3222 WOODBURN,1544000,1343000,273000,1616000
2023,District of Oak Bay,15-5804-00,V8P 5B9,,3232 WOODBURN,1565000,1344000,293000,1637000
2023,District of Oak Bay,15-5805-00,V8P 5B9,,3246 WOODBURN,1649000,1342000,390000,1732000
2023,District of Oak Bay,15-5806-00,V8P 5B9,,3260 WOODBURN,1849000,1358000,606000,1964000
2023,District of Oak Bay,15-5807-00,V8P 5B9,,3270 WOODBURN,1560000,1373000,257000,1630000
2023,District of Oak Bay,15-5808-00,V8P 5B9,,3280 WOODBURN,1837000,1427000,528000,1955000
2023,District of Oak Bay,15-5809-00,V8P 5B9,,3290 WOODBURN,1715000,1443000,336000,1779000
2023,District of Oak Bay,15-5810-00,V8P 5B9,,3300 WOODBURN,1648000,1445000,281000,1726000
2023,District of Oak Bay,15-5811-00,V8P 5B9,,3310 WOODBURN,1796000,1431000,455000,1886000
2023,District of Oak Bay,15-5812-00,V8P 5B9,,3320 WOODBURN,2011000,1417000,752000,2169000
2023,District of Oak Bay,15-5813-00,V8Z 7H5,,3330 WOODBURN,1593000,1401000,270000,1671000
2023,District of Oak Bay,15-5814-00,V8P 5C1,,3340 WOODBURN,1654000,1369000,371000,1740000
2023,District of Oak Bay,15-5815-00,V8P 5C1,,3350 WOODBURN,1498000,1380000,183000,1563000
2023,District of Oak Bay,15-5816-00,V8P 5C1,,3360 WOODBURN,1663000,1391000,366000,1757000
2023,District of Oak Bay,15-5817-00,V8P 5C1,,3370 WOODBURN,1635000,1401000,315000,1716000
2023,District of Oak Bay,15-5818-00,V8P 5C1,,3380 WOODBURN,1537000,1412000,188000,1600000
2023,District of Oak Bay,15-5819-00,V8P 5C1,,3390 WOODBURN,1933000,1414000,621000,2035000
2023,District of Oak Bay,15-5820-00,V8V 3Z9,,1587 YORK,3405000,2799000,909000,3708000
2023,District of Oak Bay,15-5821-00,V8V 3Z9,,1561 YORK,5831000,5510000,2431000,7941000
2023,District of Oak Bay,15-5823-00,V8R 2M8,,2393 TOD,1734000,1594000,312000,1906000
2023,District of Oak Bay,15-5826-00,V8S 2L6,,165 BEACH,1407000,1566000,130000,1696000
2023,District of Oak Bay,15-5827-00,V8S 2L6,,169 BEACH,1519000,1694000,153000,1847000
2023,District of Oak Bay,15-5828-00,V8R 6C8,,3075 DEVON,2859000,2206000,830000,3036000
2023,District of Oak Bay,15-5829-00,V8R 6P2,,3098 MIDLAND,2886000,2512000,659000,3171000
2023,District of Oak Bay,15-5830-00,V8R 6C8,,3069 DEVON,1986000,1840000,340000,2180000
2023,District of Oak Bay,15-5831-00,V8R 6P2,,3090 MIDLAND,2598000,2335000,531000,2866000
2023,District of Oak Bay,15-5832-00,V8R 6C8,,3061 DEVON,2005000,1864000,339000,2203000
2023,District of Oak Bay,15-5833-00,V8R 6P2,,3080 MIDLAND,2409000,2240000,401000,2641000
2023,District of Oak Bay,15-5834-00,V8R 6C8,,3053 DEVON,1933000,1864000,257000,2121000
2023,District of Oak Bay,15-5835-00,V8R 6P2,,3070 MIDLAND,2374000,2239000,360000,2599000
2023,District of Oak Bay,15-5836-00,V8R 6C8,,3047 DEVON,1927000,1863000,249000,2112000
2023,District of Oak Bay,15-5837-00,V8R 6P2,,3060 MIDLAND,2732000,2238000,1653000,3891000
2023,District of Oak Bay,15-5838-00,V8R 6C8,,3039 DEVON,1950000,1781000,362000,2143000
2023,District of Oak Bay,15-5839-00,V8R 6P2,,3050 MIDLAND,2561000,2331000,489000,2820000
2023,District of Oak Bay,15-5840-00,V8N 1R5,,3033 DEVON,3164000,1782000,2014000,3796000
2023,District of Oak Bay,15-5841-00,V8R 6P2,,3040 MIDLAND,2657000,2331000,606000,2937000
2023,District of Oak Bay,15-5842-00,V8R 6C8,,3025 DEVON,1991000,1865000,319000,2184000
2023,District of Oak Bay,15-5843-00,V8R 6P1,,3030 MIDLAND,2424000,2233000,435000,2668000
2023,District of Oak Bay,15-5844-00,V8R 6C8,,3019 DEVON,1955000,1866000,280000,2146000
2023,District of Oak Bay,15-5845-00,V8R 6P1,,3020 MIDLAND,2304000,2127000,397000,2524000
2023,District of Oak Bay,15-5846-00,V8R 6C8,,3011 DEVON,2078000,1862000,403000,2265000
2023,District of Oak Bay,15-5847-00,V8R 6P1,,3010 MIDLAND,2555000,2046000,806000,2852000
2023,District of Oak Bay,15-5848-00,V8R 2S9,,3005 DEVON,2037000,1816000,390000,2206000
2023,District of Oak Bay,15-5849-00,V8R 6P1,,3000 MIDLAND,2232000,2092000,353000,2445000
2023,District of Oak Bay,15-5850-00,V8R 6P1,,2990 MIDLAND,2125000,1887000,417000,2304000
2023,District of Oak Bay,15-5851-00,V8R 3N1,,2650 DORSET,1940000,1820000,308000,2128000
2023,District of Oak Bay,15-5853-00,V8S 2V8,,973 RUNNYMEDE,1474000,1276000,314000,1590000
2023,District of Oak Bay,15-5854-00,V8S 2X9,,2071 MCNEILL,1405000,1257000,247000,1504000
2023,District of Oak Bay,15-5855-00,V8S 2X9,,2081 MCNEILL,1472000,1249000,353000,1602000
2023,District of Oak Bay,15-5856-00,V8S 2X9,,2091 MCNEILL,1317000,1247000,169000,1416000
2023,District of Oak Bay,15-5857-00,V8S 4L8,,970 FALKLAND,1497000,1273000,348000,1621000
2023,District of Oak Bay,15-5858-00,V8S 4L8,,960 FALKLAND,1603000,1509000,211000,1720000
2023,District of Oak Bay,15-5859-00,V8S 4L8,,950 FALKLAND,1585000,1503000,199000,1702000
2023,District of Oak Bay,15-5860-00,V8S 4L8,,940 FALKLAND,1565000,1506000,174000,1680000
2023,District of Oak Bay,15-5861-00,V8S 4L8,,920 FALKLAND,1603000,1511000,214000,1725000
2023,District of Oak Bay,15-5862-00,V8S 2V8,,915 RUNNYMEDE,3216000,1503000,1869000,3372000
2023,District of Oak Bay,15-5863-00,V8S 2V8,,931 RUNNYMEDE,1589000,1489000,216000,1705000
2023,District of Oak Bay,15-5864-00,V8S 2V8,,945 RUNNYMEDE,1700000,1489000,342000,1831000
2023,District of Oak Bay,15-5865-00,V8S 2V8,,961 RUNNYMEDE,1628000,1508000,238000,1746000
2023,District of Oak Bay,15-5866-00,V8S 2M5,,598 BEACH,2138000,2222000,272000,2494000
2023,District of Oak Bay,15-5868-00,V8S 5B9,,614 INGLEWOOD,3206000,2475000,1413000,3888000
2023,District of Oak Bay,15-5869-00,V8S 5B9,,622 INGLEWOOD,3381000,2380000,1685000,4065000
2023,District of Oak Bay,15-5870-00,V8S 2M7,,630 BEACH,1655000,1726000,269000,1995000
2023,District of Oak Bay,15-5871-00,V8R 5X2,,1580 YORK,3495000,3103000,722000,3825000
2023,District of Oak Bay,15-5874-00,V8R 5X2,,1574 YORK,2344000,1990000,609000,2599000
2023,District of Oak Bay,15-5876-00,,,3575 BEACH,3609000,3143000,229000,3372000
2023,District of Oak Bay,15-5876-00,,,3575 BEACH,3609000,3143000,229000,3372000
2023,District of Oak Bay,15-5877-00,V8S 2G9,,3585 BEACH,4730000,3170000,1461000,4631000
2023,District of Oak Bay,15-5879-00,V8W 1K8,,285 KING GEORGE,4318000,2778000,2186000,4964000
2023,District of Oak Bay,15-5880-00,V8S 2J8,,287 KING GEORGE,4098000,3553000,260000,3813000
2023,District of Oak Bay,15-5881-00,V8P 4Y5,,3311 GIBBS,1213000,1030000,220000,1250000
2023,District of Oak Bay,15-5882-00,V8P 4Y4,,3304 GIBBS,1358000,1082000,347000,1429000
2023,District of Oak Bay,15-5883-00,V8P 4Y4,,3312 GIBBS,1338000,1255000,132000,1387000
2023,District of Oak Bay,15-5884-00,V8P 4Y4,,3320 GIBBS,1286200,1225000,106000,1331000
2023,District of Oak Bay,15-5885-00,V8P 4Y4,,3328 GIBBS,1358000,1272000,133000,1405000
2023,District of Oak Bay,15-5886-00,V8P 4Y4,,3336 GIBBS,1559000,1216000,424000,1640000
2023,District of Oak Bay,15-5887-00,V8P 4Y4,,3344 GIBBS,1307000,1233000,114000,1347000
2023,District of Oak Bay,15-5888-00,V8P 4Y4,,3352 GIBBS,1628000,1325000,395000,1720000
2023,District of Oak Bay,15-5889-00,V8P 4Y4,,3360 GIBBS,1484000,1412000,124000,1536000
2023,District of Oak Bay,15-5890-00,V8P 4Y4,,3368 GIBBS,1498000,1397000,148000,1545000
2023,District of Oak Bay,15-5891-00,V8P 4Y4,,3376 GIBBS,1844000,1659000,273000,1932000
2023,District of Oak Bay,15-5892-00,V8P 4Y7,,3384 CARDIFF,1899000,1503000,487000,1990000
2023,District of Oak Bay,15-5893-00,V8P 4Y7,,3392 CARDIFF,1745000,1383000,472000,1855000
2023,District of Oak Bay,15-5894-00,V8P 1R7,,2097 KENDAL,1674000,1450000,301000,1751000
2023,District of Oak Bay,15-5895-00,V8P 4Y5,,3331 GIBBS,1362000,1259000,151000,1410000
2023,District of Oak Bay,15-5896-00,V8P 2T2,,3339 GIBBS,1446000,1281000,223000,1504000
2023,District of Oak Bay,15-5897-00,V8P 4Y5,,3347 GIBBS,1561000,1303000,335000,1638000
2023,District of Oak Bay,15-5898-00,V8P 4Y5,,3355 GIBBS,1456000,1248000,276000,1524000
2023,District of Oak Bay,15-5899-00,V8P 4Y5,,3363 GIBBS,1839000,1234000,742000,1976000
2023,District of Oak Bay,15-5900-00,V8P 4Y5,,3371 GIBBS,1613000,1460000,209000,1669000
2023,District of Oak Bay,15-5901-00,V8P 4Y6,,3381 CARDIFF,1758000,1474000,361000,1835000
2023,District of Oak Bay,15-5902-00,V8P 4Y6,,3389 CARDIFF,2975000,1454000,1856000,3310000
2023,District of Oak Bay,15-5903-00,V8P 4Y6,,3399 CARDIFF,1636000,1326000,395000,1721000
2023,District of Oak Bay,15-5904-00,V8P 1S1,,2149 KENDAL,1389000,1317000,117000,1434000
2023,District of Oak Bay,15-5905-00,V8S 4X2,,2175 KENDAL,1547000,1362000,254000,1616000
2023,District of Oak Bay,15-5906-00,V8P 5A7,,3412 HENDERSON,1246000,1124000,168000,1292000
2023,District of Oak Bay,15-5909-00,V8P 1S2,,2198 KENDAL,1451000,1131000,406000,1537000
2023,District of Oak Bay,15-5910-00,V8P 1S2,,2174 KENDAL,1348000,1234000,163000,1397000
2023,District of Oak Bay,15-5911-00,V8P 1S2,,2150 KENDAL,1352000,1233000,170000,1403000
2023,District of Oak Bay,15-5912-00,V8P 4Y9,,3435 CARDIFF,1465000,1233000,298000,1531000
2023,District of Oak Bay,15-5913-00,V8P 4Y9,,3443 CARDIFF,1394000,1233000,220000,1453000
2023,District of Oak Bay,15-5914-00,V8P 4Y9,,3451 CARDIFF,1393000,1233000,214000,1447000
2023,District of Oak Bay,15-5915-00,V8P 4Y9,,3459 CARDIFF,1390000,1233000,212000,1445000
2023,District of Oak Bay,15-5916-00,V8P 4Y9,,3467 CARDIFF,1407000,1233000,227000,1460000
2023,District of Oak Bay,15-5917-00,V8P 4Y9,,3475 CARDIFF,1508000,1230000,348000,1578000
2023,District of Oak Bay,15-5918-00,V8P 4Z1,,3472 CARDIFF,1354000,1177000,233000,1410000
2023,District of Oak Bay,15-5919-00,V8P 4Z1,,3470 CARDIFF,1288000,1193000,146000,1339000
2023,District of Oak Bay,15-5920-00,V8P 4Z1,,3462 CARDIFF,1446000,1209000,304000,1513000
2023,District of Oak Bay,15-5924-00,V8P 4Y8,,3430 CARDIFF,1342000,1214000,178000,1392000
2023,District of Oak Bay,15-5925-00,V8P 4Y8,,3422 CARDIFF,1375000,1242000,176000,1418000
2023,District of Oak Bay,15-5926-00,V8R 5N5,,1601 YALE,1588000,1245000,498000,1743000
2023,District of Oak Bay,15-5927-00,V8R 5N5,,1587 YALE,1294000,1245000,159000,1404000
2023,District of Oak Bay,15-5932-00,V8S 3C3,,2098 WINDSOR,2850000,2218000,944000,3162000
2023,District of Oak Bay,15-5933-00,V8S 3C3,,2104 WINDSOR,2766000,1716000,1371000,3087000
2023,District of Oak Bay,15-5934-00,V8S 2Z8,,2071 STONEHEWER,2069000,1507000,724000,2231000
2023,District of Oak Bay,16-5936-00,V8S 2K2,,240 KING GEORGE,2753000,2585000,686000,3271000
2023,District of Oak Bay,16-5938-00,V9C 4A7,,2120 CADBORO BAY,2727000,2584000,417000,3001000
2023,District of Oak Bay,16-5939-10,V8S 4A8,,1701 BEACH,18596000,3906000,17164000,21070000
2023,District of Oak Bay,16-5941-00,V8R 1G2,,1707 MONTEREY,868600,986000,13700,999700
2023,District of Oak Bay,16-5941-01,V5R 5W2,,1707 MONTEREY,340000,263000,120000,383000
2023,District of Oak Bay,16-5941-01,V8R 1G2,,1707 MONTEREY,340000,263000,120000,383000
2023,District of Oak Bay,16-5942-00,V8R 1G2,, MONTEREY,797000,920000,0,920000
2023,District of Oak Bay,16-5942-01,V7M 0E9,, MONTEREY,219600,162000,87600,249600
2023,District of Oak Bay,16-5942-01,V8R 1G2,, MONTEREY,219600,162000,87600,249600
2023,District of Oak Bay,16-5943-00,V8R 5X3,,1756 MONTEITH,1714000,1487000,417000,1904000
2023,District of Oak Bay,16-5943-00,V8R 5X3,,1756 MONTEITH,1714000,1487000,417000,1904000
2023,District of Oak Bay,16-5944-00,V8R 1G2,, MONTEREY,330000,387000,0,387000
2023,District of Oak Bay,16-5945-00,V8R 1G2,, MONTEREY,279000,324000,0,324000
2023,District of Oak Bay,16-5946-00,V8R 1G2,, MONTEREY,544000,635000,0,635000
2023,District of Oak Bay,16-5947-00,V8V 3K2,,2333 BEACH,11842000,3999000,8991000,12990000
2023,District of Oak Bay,16-5948-00,V8R 1G2,, BEACH,4078000,4713000,20000,4733000
2023,District of Oak Bay,16-5948-01,V8R 1N8,, BEACH,94800,54100,50500,104600
2023,District of Oak Bay,16-5948-01,V8R 1G2,, BEACH,94800,54100,50500,104600
2023,District of Oak Bay,16-5952-00,V8R 6M2,,3355 BEACH,12583000,6031000,5866000,11897000
2023,District of Oak Bay,16-5954-00,V8V 3K2,,2161 HAULTAIN,3151000,2669000,802000,3471000
2023,District of Oak Bay,16-5954-00,V8V 3K2,,2161 HAULTAIN,3151000,2669000,802000,3471000
2023,District of Oak Bay,16-5955-00,V8P 5B8,,3401 WOODBURN,1716000,1568000,220000,1788000
2023,District of Oak Bay,16-5956-00,V8P 5B8,,3411 WOODBURN,1725000,1562000,232000,1794000
2023,District of Oak Bay,16-5957-00,V8P 5B8,,3421 WOODBURN,1622000,1555000,128000,1683000
2023,District of Oak Bay,16-5958-00,V8P 5B8,,3431 WOODBURN,1581000,1441000,209000,1650000
2023,District of Oak Bay,16-5959-00,V8P 5C1,,3430 WOODBURN,1938000,1310000,647000,1957000
2023,District of Oak Bay,16-5960-00,V8P 5C1,,3420 WOODBURN,2550000,1426000,1354000,2780000
2023,District of Oak Bay,16-5961-00,V8P 5C1,,3410 WOODBURN,1779000,1426000,439000,1865000
2023,District of Oak Bay,16-5962-00,V8P 5C1,,3400 WOODBURN,1592000,1426000,230000,1656000
2023,District of Oak Bay,16-5963-00,V8P 5A8,,3413 HENDERSON,1392000,1177000,269000,1446000
2023,District of Oak Bay,16-5964-00,V8P 5A8,,3423 HENDERSON,1383000,1177000,262000,1439000
2023,District of Oak Bay,16-5965-00,V8W 3S1,,3433 HENDERSON,1293000,1132000,214000,1346000
2023,District of Oak Bay,16-5966-00,V8P 5A8,,3443 HENDERSON,1232000,1081000,210000,1291000
2023,District of Oak Bay,16-5967-00,V8Z 1E8,, HENDERSON,887000,1029000,0,1029000
2023,District of Oak Bay,16-5968-00,V8P 5A8,,3463 HENDERSON,1282000,1108000,226000,1334000
2023,District of Oak Bay,16-5969-00,V8P 5A8,,3473 HENDERSON,1206000,1081000,169000,1250000
2023,District of Oak Bay,16-5970-00,V8P 5A9,,3472 HENDERSON,1260000,1109000,200000,1309000
2023,District of Oak Bay,16-5971-00,V8P 5A9,,3462 HENDERSON,1241000,1110000,182000,1292000
2023,District of Oak Bay,16-5972-00,V8P 5A9,,3452 HENDERSON,1364000,1110000,326000,1436000
2023,District of Oak Bay,16-5973-00,V8P 5A9,,3442 HENDERSON,1235000,1109000,174000,1283000
2023,District of Oak Bay,16-5974-00,V8P 5A9,,3432 HENDERSON,1254000,1109000,194000,1303000
2023,District of Oak Bay,16-5975-00,V8P 4X4,,3476 PLYMOUTH,1615000,1301000,400000,1701000
2023,District of Oak Bay,16-5976-00,V8P 4X4,,3466 PLYMOUTH,1407000,1345000,112000,1457000
2023,District of Oak Bay,16-5977-00,V8P 4X4,,3456 PLYMOUTH,1732000,1370000,463000,1833000
2023,District of Oak Bay,16-5978-00,V8P 4X4,,3446 PLYMOUTH,2805000,1375000,1757000,3132000
2023,District of Oak Bay,16-5978-00,V8P 4X4,,3446 PLYMOUTH,2805000,1375000,1757000,3132000
2023,District of Oak Bay,16-5979-00,V8P 4X5,,3449 PLYMOUTH,1633000,1330000,391000,1721000
2023,District of Oak Bay,16-5980-00,V8P 1S3,,2053 RENFREW,1447000,1293000,199000,1492000
2023,District of Oak Bay,16-5981-00,V8P 1S3,,2057 RENFREW,1573000,1333000,314000,1647000
2023,District of Oak Bay,16-5982-00,V8P 1S3,,2063 RENFREW,1578000,1458000,181000,1639000
2023,District of Oak Bay,16-5983-00,V8P 1S3,,2073 RENFREW,1809000,1501000,445000,1946000
2023,District of Oak Bay,16-5984-00,V8P 1S3,,2083 RENFREW,1569000,1402000,236000,1638000
2023,District of Oak Bay,16-5985-00,V8P 1S3,,2093 RENFREW,1432000,1292000,190000,1482000
2023,District of Oak Bay,16-5986-00,V8P 1S4,,2090 RENFREW,1609000,1464000,219000,1683000
2023,District of Oak Bay,16-5987-00,V8P 1S4,,2080 RENFREW,1497000,1336000,225000,1561000
2023,District of Oak Bay,16-5987-00,V8P 1S4,,2080 RENFREW,1497000,1336000,225000,1561000
2023,District of Oak Bay,16-5988-00,V8P 1S4,,2070 RENFREW,1488000,1329000,224000,1553000
2023,District of Oak Bay,16-5989-00,V8P 1S4,,2060 RENFREW,1673000,1383000,375000,1758000
2023,District of Oak Bay,16-5990-00,V8P 1S4,,2058 RENFREW,1584000,1478000,168000,1646000
2023,District of Oak Bay,16-5991-00,V8P 1S4,,2054 RENFREW,1474000,1300000,236000,1536000
2023,District of Oak Bay,16-5992-00,V8P 4X6,,3459 PLYMOUTH,1589000,1313000,361000,1674000
2023,District of Oak Bay,16-5993-00,V8P 4X6,,3471 PLYMOUTH,1392000,1309000,134000,1443000
2023,District of Oak Bay,16-5994-00,V8P 4X4,,3436 PLYMOUTH,1586000,1355000,296000,1651000
2023,District of Oak Bay,16-5995-00,V8S 2H1,,1930 CRESCENT,3045000,1928000,1722000,3650000
2023,District of Oak Bay,16-5996-00,V8S 2X7,,2021 MCNEILL,2155000,1053000,1268000,2321000
2023,District of Oak Bay,16-5997-00,V8S 2X7,,2025 MCNEILL,1349000,1265000,184000,1449000
2023,District of Oak Bay,16-5998-00,V8S 5G6,,1015 DEAL,1333000,1320000,126000,1446000
2023,District of Oak Bay,16-5999-00,V8R 6K9,,2990 BEACH,5055000,3372000,2071000,5443000
2023,District of Oak Bay,16-6000-00,V8R 6K9,,2980 BEACH,2986400,3179000,45900,3224900
2023,District of Oak Bay,16-6001-00,V8Z 1E8,,3461 HENDERSON,13123000,9444000,4182000,13626000
2023,District of Oak Bay,16-6001-10,V8R 5K5,,3300 CADBORO BAY,10046300,7631600,3404000,11035600
2023,District of Oak Bay,16-6001-10,V8R 5K5,,3300 CADBORO BAY,10046300,7631600,3404000,11035600
2023,District of Oak Bay,16-6002-00,V8S 1W7,,910 FOUL BAY,35700,38200,0,38200
2023,District of Oak Bay,16-6003-00,V8S 4H8,,928 FOUL BAY,884000,773000,171000,944000
2023,District of Oak Bay,16-6005-00,T2T 3L9,,2145 LORNE,1382000,1357000,125000,1482000
2023,District of Oak Bay,16-6006-00,V8S 2H6,,2144 QUIMPER,2232000,1311000,1168000,2479000
2023,District of Oak Bay,16-6007-00,V8R 5M3,,2928 HENDERSON,1260000,1206000,166000,1372000
2023,District of Oak Bay,16-6008-00,V8R 5M3,,2920 HENDERSON,1294000,1082000,331000,1413000
2023,District of Oak Bay,16-6009-00,V8S 4X2,,1342 OLIVER,1787000,1528000,393000,1921000
2023,District of Oak Bay,16-6010-00,V8S 4X2,,1332 OLIVER,1619000,1529000,234000,1763000
2023,District of Oak Bay,16-6015-00,V8R 6B6,,3130 UPLANDS,2566500,2718000,50600,2768600
2023,District of Oak Bay,16-6016-00,V8R 3R9,,3165 SHERRINGHAM,6250000,2566000,4007000,6573000
2023,District of Oak Bay,16-6017-00,V8R 3R9,,3175 SHERRINGHAM,2222900,2359000,41100,2400100
2023,District of Oak Bay,16-6018-00,V8R 3R9,,3185 SHERRINGHAM,2009800,2120000,42900,2162900
2023,District of Oak Bay,16-6019-00,V8R 3R9,,3145 SHERRINGHAM,2211000,2124000,234000,2358000
2023,District of Oak Bay,16-6020-00,V8R 3R9,,3155 SHERRINGHAM,4857000,2363000,2902000,5265000
2023,District of Oak Bay,16-6022-00,V8S 5A8,,665 BYNG,2091000,1768000,712000,2480000
2023,District of Oak Bay,16-6024-00,V8V 3K2,,2129 FLORENCE,3150400,3062000,427000,3489000
2023,District of Oak Bay,16-6025-00,V8R 6T4,,1418 NEWPORT,9831000,7032000,3787000,10819000
2023,District of Oak Bay,16-6026-00,V8S 2V1,,985 ISLAND,1168900,1198000,65600,1263600
2023,District of Oak Bay,16-6027-00,V8R 0A7,,977 ISLAND,1287000,1242000,111000,1353000
2023,District of Oak Bay,16-6028-00,V8S 2H6,,2104 QUIMPER,1405000,1334000,173000,1507000
2023,District of Oak Bay,16-6029-00,V8S 2H9,,2105 LORNE,1389000,1334000,160000,1494000
2023,District of Oak Bay,16-6030-00,V8R 6L9,,3235 BEACH,5983000,4703000,744000,5447000
2023,District of Oak Bay,16-6030-00,V8R 6L9,,3235 BEACH,5983000,4703000,744000,5447000
2023,District of Oak Bay,16-6031-00,V8R 1B2,,3225 BEACH,6166000,4722000,952000,5674000
2023,District of Oak Bay,16-6032-00,V8R 6J3,,2183 BEACH,2184000,1924000,469000,2393000
2023,District of Oak Bay,16-6033-00,V8R 6J9,,2151 BEACH,1904000,1751000,313000,2064000
2023,District of Oak Bay,16-6034-00,V8S 2H5,,2148 QUIMPER,1546000,1439000,246000,1685000
2023,District of Oak Bay,16-6034-00,V8R 1G9,,2148 QUIMPER,1546000,1439000,246000,1685000
2023,District of Oak Bay,16-6035-00,V8S 2J4,,44 MAQUINNA,1535000,1438000,236000,1674000
2023,District of Oak Bay,16-6035-00,V8S 2J4,,44 MAQUINNA,1535000,1438000,236000,1674000
2023,District of Oak Bay,16-6036-00,V8S 3C3,,2084 WINDSOR,1730000,1518000,359000,1877000
2023,District of Oak Bay,16-6037-00,V8S 3C3,,2082 WINDSOR,1665000,1574000,221000,1795000
2023,District of Oak Bay,16-6038-00,V8Z 1E8,,2121 CADBORO BAY,1483000,1713000,0,1713000
2023,District of Oak Bay,16-6039-00,V8R 1G2,,1771 ELGIN,2816000,2682000,524000,3206000
2023,District of Oak Bay,16-6040-00,V8P 1P3,,2200 OAK BAY,4104000,3379000,813000,4192000
2023,District of Oak Bay,16-6041-00,V8R 5K8,,3680 CADBORO BAY,2678000,2396000,463000,2859000
2023,District of Oak Bay,16-6042-00,V8R 5K8,,3660 CADBORO BAY,1629900,1712000,38600,1750600
2023,District of Oak Bay,16-6043-00,V8S 4P6,,1205 HEWLETT,2423000,1288000,1442000,2730000
2023,District of Oak Bay,16-6044-00,V8S 4P6,,1217 HEWLETT,2282000,1234000,1350000,2584000
2023,District of Oak Bay,16-6045-00,V8S 2H8,,2074 LORNE,1872000,1594000,425000,2019000
2023,District of Oak Bay,16-6046-00,V8S 2J8,,105 KING GEORGE,2644000,2301000,867000,3168000
2023,District of Oak Bay,16-6047-00,V8P 1R7,,2081 KENDAL,1515000,1292000,283000,1575000
2023,District of Oak Bay,16-6048-00,V8P 1R7,,2071 KENDAL,1441000,1240000,269000,1509000
2023,District of Oak Bay,16-6049-00,V8P 1R7,,2063 KENDAL,1277000,1200000,116000,1316000
2023,District of Oak Bay,16-6050-00,V8P 1R7,,2055 KENDAL,1302000,1209000,141000,1350000
2023,District of Oak Bay,16-6051-00,V8P 1R7,,2047 KENDAL,1337000,1236000,148000,1384000
2023,District of Oak Bay,16-6052-00,V8P 1R7,,2039 KENDAL,1576000,1255000,387000,1642000
2023,District of Oak Bay,16-6053-00,V8P 1R7,,2031 KENDAL,1365000,1235000,179000,1414000
2023,District of Oak Bay,16-6054-00,V8P 1R7,,2023 KENDAL,1355000,1227000,180000,1407000
2023,District of Oak Bay,16-6055-00,V8P 1R7,,2015 KENDAL,1529000,1355000,242000,1597000
2023,District of Oak Bay,16-6056-00,V8P 1R7,,2007 KENDAL,1541000,1352000,255000,1607000
2023,District of Oak Bay,16-6057-00,V8P 1R8,,2008 KENDAL,1522000,1385000,207000,1592000
2023,District of Oak Bay,16-6059-00,V8P 1R8,,2024 KENDAL,1531000,1316000,287000,1603000
2023,District of Oak Bay,16-6060-00,V8P 4X4,,3428 PLYMOUTH,1423000,1217000,268000,1485000
2023,District of Oak Bay,16-6061-00,V8P 1R8,,2032 KENDAL,1625000,1235000,486000,1721000
2023,District of Oak Bay,16-6062-00,V8P 4X5,,3435 PLYMOUTH,1515000,1239000,356000,1595000
2023,District of Oak Bay,16-6063-00,V8P 1R9,,2056 KENDAL,1370000,1281000,139000,1420000
2023,District of Oak Bay,16-6064-00,V8P 1R9,,2064 KENDAL,1723000,1358000,454000,1812000
2023,District of Oak Bay,16-6065-00,V8P 1R9,,2072 KENDAL,2713000,1371000,1664000,3035000
2023,District of Oak Bay,16-6066-00,V8P 1R9,,2080 KENDAL,1632000,1334000,385000,1719000
2023,District of Oak Bay,16-6067-00,V8P 1R9,,2086 KENDAL,1509000,1277000,310000,1587000
2023,District of Oak Bay,16-6068-00,V8P 1R9,,2096 KENDAL,1377000,1234000,200000,1434000
2023,District of Oak Bay,16-6069-00,V8P 4Y9,,3481 CARDIFF,1372000,1234000,183000,1417000
2023,District of Oak Bay,16-6070-00,V8N 2S9,,3487 CARDIFF,1308000,1248000,112000,1360000
2023,District of Oak Bay,16-6071-00,B4V 1L1,,3493 CARDIFF,1315000,1206000,160000,1366000
2023,District of Oak Bay,16-6071-00,V8P 4Y9,,3493 CARDIFF,1315000,1206000,160000,1366000
2023,District of Oak Bay,16-6072-00,V8P 4Y9,,3499 CARDIFF,1307000,1227000,126000,1353000
2023,District of Oak Bay,16-6073-00,V8P 4Z2,,3501 CARDIFF,1519000,1268000,320000,1588000
2023,District of Oak Bay,16-6074-00,V8P 4Z2,,3505 CARDIFF,1378000,1286000,141000,1427000
2023,District of Oak Bay,16-6075-00,V8P 4Z2,,3511 CARDIFF,1531000,1299000,308000,1607000
2023,District of Oak Bay,16-6076-00,V6R 1B6,,3515 CARDIFF,1449000,1284000,225000,1509000
2023,District of Oak Bay,16-6077-00,V8P 4Z2,,3519 CARDIFF,1453000,1274000,251000,1525000
2023,District of Oak Bay,16-6078-00,V8P 4Z2,,3523 CARDIFF,1395000,1263000,189000,1452000
2023,District of Oak Bay,16-6079-00,V8P 4Z2,,3527 CARDIFF,1367000,1251000,171000,1422000
2023,District of Oak Bay,16-6080-00,V8P 4Z2,,3531 CARDIFF,1320000,1247000,121000,1368000
2023,District of Oak Bay,16-6081-00,V8P 4Z4,,3530 CARDIFF,1465000,1232000,309000,1541000
2023,District of Oak Bay,16-6082-00,V8P 4Z7,,3528 REDWOOD,1485000,1298000,251000,1549000
2023,District of Oak Bay,16-6083-00,V8P 4Z6,,3515 REDWOOD,1504000,1228000,354000,1582000
2023,District of Oak Bay,16-6083-00,V8P 3K1,,3515 REDWOOD,1504000,1228000,354000,1582000
2023,District of Oak Bay,16-6084-00,V8P 4Z3,,3510 CARDIFF,2721000,1228000,1786000,3014000
2023,District of Oak Bay,16-6085-00,V8P 4Z3,,3506 CARDIFF,1398000,1235000,222000,1457000
2023,District of Oak Bay,16-6086-00,V5T 1P4,,3502 CARDIFF,1381000,1295000,132000,1427000
2023,District of Oak Bay,16-6086-00,,,3502 CARDIFF,1381000,1295000,132000,1427000
2023,District of Oak Bay,16-6086-00,V8R 1Y5,,3502 CARDIFF,1381000,1295000,132000,1427000
2023,District of Oak Bay,16-6086-00,V8P 4Z3,,3502 CARDIFF,1381000,1295000,132000,1427000
2023,District of Oak Bay,16-6087-00,V8P 4Z1,,3496 CARDIFF,1278000,1133000,195000,1328000
2023,District of Oak Bay,16-6088-00,V8P 4Z1,,3490 CARDIFF,1250000,1166000,129000,1295000
2023,District of Oak Bay,16-6089-00,V8P 4Z1,,3484 CARDIFF,1210000,1140000,118000,1258000
2023,District of Oak Bay,16-6090-00,V8P 4Z1,,3478 CARDIFF,1196000,1116000,126000,1242000
2023,District of Oak Bay,16-6091-00,V8P 1V5,,2095 AVONDALE,2368000,1368000,1206000,2574000
2023,District of Oak Bay,16-6092-00,V8P 1V5,,2085 AVONDALE,1590000,1309000,365000,1674000
2023,District of Oak Bay,16-6093-00,V8P 1V5,,2075 AVONDALE,1455000,1250000,274000,1524000
2023,District of Oak Bay,16-6094-00,V8P 1V5,,2069 AVONDALE,2785000,1191000,1947000,3138000
2023,District of Oak Bay,16-6095-00,V8P 1V5,,2065 AVONDALE,1541000,1168000,491000,1659000
2023,District of Oak Bay,16-6096-00,V8P 1V5,,2059 AVONDALE,1246000,1184000,107000,1291000
2023,District of Oak Bay,16-6097-00,V8P 1V5,,2051 AVONDALE,1441000,1197000,304000,1501000
2023,District of Oak Bay,16-6098-00,V8P 1V5,,2045 AVONDALE,1509000,1209000,394000,1603000
2023,District of Oak Bay,16-6099-00,V8P 1V5,,2037 AVONDALE,1295000,1199000,132000,1331000
2023,District of Oak Bay,16-6100-00,V8P 4X6,,3481 PLYMOUTH,1345000,1239000,155000,1394000
2023,District of Oak Bay,16-6101-00,V8P 4X4,,3486 PLYMOUTH,1470000,1133000,440000,1573000
2023,District of Oak Bay,16-6102-00,V8P 4X4,,3496 PLYMOUTH,1297000,1026000,332000,1358000
2023,District of Oak Bay,16-6103-00,T8B 1B6,,3504 PLYMOUTH,1465000,1315000,216000,1531000
2023,District of Oak Bay,16-6104-00,V8P 4X4,,3508 PLYMOUTH,1387000,1170000,277000,1447000
2023,District of Oak Bay,16-6105-00,V8P 4X4,,3512 PLYMOUTH,1682000,1541000,216000,1757000
2023,District of Oak Bay,16-6106-00,V8P 4X4,,3516 PLYMOUTH,1615000,1372000,319000,1691000
2023,District of Oak Bay,16-6107-00,V8P 4X4,,3520 PLYMOUTH,1680000,1495000,256000,1751000
2023,District of Oak Bay,16-6108-00,V8P 4X4,,3524 PLYMOUTH,1742000,1537000,261000,1798000
2023,District of Oak Bay,16-6109-00,V8P 4X4,,3528 PLYMOUTH,1886000,1553000,431000,1984000
2023,District of Oak Bay,16-6110-00,V8P 4X4,,3532 PLYMOUTH,2240000,1886000,482000,2368000
2023,District of Oak Bay,16-6111-00,V8P 4X4,,3536 PLYMOUTH,1463000,1401000,116000,1517000
2023,District of Oak Bay,16-6112-00,V8P 4X4,,3540 PLYMOUTH,1674000,1355000,411000,1766000
2023,District of Oak Bay,16-6113-00,V8P 4Z8,,3551 REDWOOD,1396000,1233000,223000,1456000
2023,District of Oak Bay,16-6114-00,V8N 6A7,,3544 PLYMOUTH,1398000,1220000,241000,1461000
2023,District of Oak Bay,16-6115-00,V8P 4Z7,,3550 REDWOOD,1181000,1074000,157000,1231000
2023,District of Oak Bay,16-6116-00,V6R 2N4,,3546 REDWOOD,1255000,1155000,153000,1308000
2023,District of Oak Bay,16-6117-00,V8P 4Z7,,3542 REDWOOD,1523000,1153000,462000,1615000
2023,District of Oak Bay,16-6118-00,V8P 4Z7,,3538 REDWOOD,1547000,1256000,367000,1623000
2023,District of Oak Bay,16-6119-00,V8P 4Z7,,3534 REDWOOD,1557000,1283000,356000,1639000
2023,District of Oak Bay,16-6120-00,V8P 4Z7,,3530 REDWOOD,1441000,1369000,128000,1497000
2023,District of Oak Bay,16-6121-00,V8P 4Z6,,3519 REDWOOD,1506000,1284000,281000,1565000
2023,District of Oak Bay,16-6122-00,V8P 4Z6,,3523 REDWOOD,1439000,1206000,303000,1509000
2023,District of Oak Bay,16-6123-00,V8P 4Z6,,3527 REDWOOD,1310000,1188000,169000,1357000
2023,District of Oak Bay,16-6124-00,V8P 4Z6,,3531 REDWOOD,1447000,1251000,262000,1513000
2023,District of Oak Bay,16-6125-00,V8P 4Z6,,3535 REDWOOD,1264000,1188000,126000,1314000
2023,District of Oak Bay,16-6126-00,V8P 4Z6,,3539 REDWOOD,1482000,1321000,222000,1543000
2023,District of Oak Bay,16-6127-00,V8P 4Z6,,3543 REDWOOD,1730000,1497000,309000,1806000
2023,District of Oak Bay,16-6128-00,V8P 4X7,,3539 PLYMOUTH,1503000,1409000,153000,1562000
2023,District of Oak Bay,16-6128-00,V8S 4W3,,3539 PLYMOUTH,1503000,1409000,153000,1562000
2023,District of Oak Bay,16-6129-00,V8P 4X7,,3535 PLYMOUTH,1720000,1275000,534000,1809000
2023,District of Oak Bay,16-6130-00,V8P 4X7,,3531 PLYMOUTH,1514000,1304000,279000,1583000
2023,District of Oak Bay,16-6131-00,V8P 4X7,,3509 PLYMOUTH,1711000,1270000,539000,1809000
2023,District of Oak Bay,16-6131-00,V8P 4X7,,3509 PLYMOUTH,1711000,1270000,539000,1809000
2023,District of Oak Bay,16-6132-00,V8P 1V4,,2034 AVONDALE,1564000,1266000,377000,1643000
2023,District of Oak Bay,16-6133-00,V8P 1V4,,2038 AVONDALE,1499000,1309000,262000,1571000
2023,District of Oak Bay,16-6134-00,V8P 1V4,,2046 AVONDALE,1415000,1310000,158000,1468000
2023,District of Oak Bay,16-6135-00,V8P 1V4,,2052 AVONDALE,1599000,1223000,475000,1698000
2023,District of Oak Bay,16-6136-00,V8P 1V4,,2060 AVONDALE,1370000,1196000,257000,1453000
2023,District of Oak Bay,16-6137-00,V8P 1V4,,2066 AVONDALE,1473000,1215000,330000,1545000
2023,District of Oak Bay,16-6138-00,V8P 1V4,,2074 AVONDALE,1451000,1234000,289000,1523000
2023,District of Oak Bay,16-6139-00,V8P 1V4,,2086 AVONDALE,1461000,1251000,280000,1531000
2023,District of Oak Bay,16-6140-00,V8P 1V4,,2096 AVONDALE,1584000,1241000,440000,1681000
2023,District of Oak Bay,16-6141-00,V8R 6M6,,3475 BEACH,3636000,3164000,242000,3406000
2023,District of Oak Bay,16-6142-00,V9A 0A1,,3465 BEACH,3735000,3310000,179000,3489000
2023,District of Oak Bay,16-6143-00,V8R 6M6,,3445 BEACH,8814000,3350000,5277000,8627000
2023,District of Oak Bay,16-6144-00,V8R 2M8,,2389 TOD,1680000,1707000,118000,1825000
2023,District of Oak Bay,16-6145-00,V8S 4M5,,2092 FALKLAND,2469000,1729000,976000,2705000
2023,District of Oak Bay,16-6146-00,V8S 4M5,,2094 FALKLAND,2558000,1822000,1017000,2839000
2023,District of Oak Bay,16-6147-00,V8S 4M5,,2096 FALKLAND,2786000,1508000,1644000,3152000
2023,District of Oak Bay,16-6148-00,V8S 4M5,,2098 FALKLAND,1779000,1541000,390000,1931000
2023,District of Oak Bay,16-6149-00,V8S 4M5,,2100 FALKLAND,1857000,1749000,253000,2002000
2023,District of Oak Bay,16-6150-00,V8S 2G4,,995 BRIGHTON,119000,128000,0,128000
2023,District of Oak Bay,16-6151-00,V8S 2G4,, BRIGHTON,191000,205000,0,205000
2023,District of Oak Bay,16-6152-00,V8S 2G4,, BRIGHTON,289000,310000,0,310000
2023,District of Oak Bay,16-6153-00,V8S 4T2,,1106 HAMPSHIRE,1283000,1215000,161000,1376000
2023,District of Oak Bay,16-6154-00,V6K 1Y6,,1146 HAMPSHIRE,1274000,1216000,151000,1367000
2023,District of Oak Bay,16-6155-00,V8R 6M6,,3525 BEACH,3138000,3000000,148000,3148000
2023,District of Oak Bay,16-6156-00,V8R 6M6,,3535 BEACH,4126000,3022000,1025000,4047000
2023,District of Oak Bay,16-6157-00,V8R 6C3,,2410 NOTTINGHAM,1641000,1453000,341000,1794000
2023,District of Oak Bay,16-6158-00,V8R 6C3,,2420 NOTTINGHAM,1975000,1453000,691000,2144000
2023,District of Oak Bay,16-6159-00,V8S 5G3,,904 DEAL,2603000,2321000,845000,3166000
2023,District of Oak Bay,16-6160-00,V8S 5G3,,906 DEAL,1870000,1569000,452000,2021000
2023,District of Oak Bay,16-6161-00,V8S 5G3,,908 DEAL,1889000,1555000,472000,2027000
2023,District of Oak Bay,16-6162-00,V8S 5G3,,910 DEAL,1869000,1555000,437000,1992000
2023,District of Oak Bay,16-6163-00,V8R 6T4,,912 DEAL,1644000,1554000,202000,1756000
2023,District of Oak Bay,16-6167-00,V8S 5G4,,903 DEAL,2441000,2201000,748000,2949000
2023,District of Oak Bay,16-6168-00,V8S 5G3,,902 DEAL,2072000,2107000,386000,2493000
2023,District of Oak Bay,16-6171-00,V8P 5A9,,3476 HENDERSON,1279000,1129000,205000,1334000
2023,District of Oak Bay,16-6172-00,V2Y 2R4,,3480 HENDERSON,1283000,1130000,207000,1337000
2023,District of Oak Bay,16-6173-00,V8P 5A9,,3484 HENDERSON,1236000,1129000,158000,1287000
2023,District of Oak Bay,16-6174-00,V8P 5A9,,3488 HENDERSON,1191000,1112000,122000,1234000
2023,District of Oak Bay,16-6175-00,V8P 5B8,,3492 HENDERSON,1205000,1126000,121000,1247000
2023,District of Oak Bay,16-6175-00,V8R 2R4,,3492 HENDERSON,1205000,1126000,121000,1247000
2023,District of Oak Bay,16-6175-00,V7J 3A6,,3492 HENDERSON,1205000,1126000,121000,1247000
2023,District of Oak Bay,16-6176-00,V6P 5R9,,3496 HENDERSON,1370000,1127000,321000,1448000
2023,District of Oak Bay,16-6177-00,V8N 6K1,,3500 HENDERSON,1123000,1058000,111000,1169000
2023,District of Oak Bay,16-6178-00,V8P 5B1,,3504 HENDERSON,1160000,1081000,125000,1206000
2023,District of Oak Bay,16-6179-00,V8Z 7H5,,3508 HENDERSON,1165000,1077000,123000,1200000
2023,District of Oak Bay,16-6180-00,V8P 5B1,,3512 HENDERSON,1173000,1058000,168000,1226000
2023,District of Oak Bay,16-6181-00,V8V 4A6,,3516 HENDERSON,1134000,1059000,122000,1181000
2023,District of Oak Bay,16-6182-00,V8P 5B1,,3520 HENDERSON,1129000,1058000,114000,1172000
2023,District of Oak Bay,16-6182-00,V8T 2N3,,3520 HENDERSON,1129000,1058000,114000,1172000
2023,District of Oak Bay,16-6183-00,V8P 5B1,,3524 HENDERSON,1249000,1081000,225000,1306000
2023,District of Oak Bay,16-6184-00,V8P 5B1,,3528 HENDERSON,1209000,1078000,176000,1254000
2023,District of Oak Bay,16-6185-00,V8P 5B1,,3532 HENDERSON,1221000,1084000,194000,1278000
2023,District of Oak Bay,16-6186-00,V7G 1V4,,3536 HENDERSON,1199000,1077000,179000,1256000
2023,District of Oak Bay,16-6186-00,V7G 1V4,,3536 HENDERSON,1199000,1077000,179000,1256000
2023,District of Oak Bay,16-6187-00,V8P 5B1,,3540 HENDERSON,1277000,1085000,251000,1336000
2023,District of Oak Bay,16-6188-00,V8P 5B1,,3544 HENDERSON,1219000,1113000,152000,1265000
2023,District of Oak Bay,16-6189-00,V8P 5B1,,3548 HENDERSON,1279000,1123000,221000,1344000
2023,District of Oak Bay,16-6190-00,V8P 5B1,,3552 HENDERSON,1406000,1069000,417000,1486000
2023,District of Oak Bay,16-6191-00,V8P 2B5,,2083 FREDERICK NORRIS,1201000,1074000,161000,1235000
2023,District of Oak Bay,16-6192-00,V8P 2B2,,2070 FREDERICK NORRIS,1191000,1107000,123000,1230000
2023,District of Oak Bay,16-6193-00,V8P 5B4,,3564 HENDERSON,1193000,1097000,139000,1236000
2023,District of Oak Bay,16-6194-00,V8P 2R5,,2073 CEDAR HILL CROSS,1354000,1253000,151000,1404000
2023,District of Oak Bay,16-6195-00,V8Y 1X9,,3477 HENDERSON,1136600,1081000,98200,1179200
2023,District of Oak Bay,16-6196-00,V8P 5A8,,3481 HENDERSON,1218000,1081000,174000,1255000
2023,District of Oak Bay,16-6197-00,V8P 5A8,,3485 HENDERSON,1257000,1092000,209000,1301000
2023,District of Oak Bay,16-6198-00,V8P 5A8,,3489 HENDERSON,1207000,1077000,182000,1259000
2023,District of Oak Bay,16-6199-00,V8P 5A8,,3493 HENDERSON,1171000,1100000,119000,1219000
2023,District of Oak Bay,16-6199-00,V8P 5A8,,3493 HENDERSON,1171000,1100000,119000,1219000
2023,District of Oak Bay,16-6200-00,V8P 5A8,,3497 HENDERSON,1133000,1067000,111000,1178000
2023,District of Oak Bay,16-6201-00,V8P 5A8,,3499 HENDERSON,1235000,1078000,213000,1291000
2023,District of Oak Bay,16-6202-00,V8P 5B2,,3501 HENDERSON,1346000,1101000,302000,1403000
2023,District of Oak Bay,16-6203-00,V8P 5B2,,3505 HENDERSON,1215000,1110000,157000,1267000
2023,District of Oak Bay,16-6204-00,V8P 5B2,,3509 HENDERSON,1170000,1077000,138000,1215000
2023,District of Oak Bay,16-6205-00,V8P 5B2,,3513 HENDERSON,1232000,1134000,148000,1282000
2023,District of Oak Bay,16-6206-00,,,3517 HENDERSON,1190000,1084000,249000,1333000
2023,District of Oak Bay,16-6206-00,V8N 3E7,,3517 HENDERSON,1190000,1084000,249000,1333000
2023,District of Oak Bay,16-6207-00,V9A 3Z2,,3521 HENDERSON,1172000,1096000,123000,1219000
2023,District of Oak Bay,16-6208-00,V8P 5B3,,3525 HENDERSON,1270000,1109000,212000,1321000
2023,District of Oak Bay,16-6209-00,V8P 5B3,,3529 HENDERSON,1165900,1110000,96300,1206300
2023,District of Oak Bay,16-6216-00,V8R 1R4,,2161 CUBBON,1566000,1493000,212000,1705000
2023,District of Oak Bay,16-6217-00,V8S 4A8,,2645 SHADY,1851000,2024000,0,2024000
2023,District of Oak Bay,16-6220-00,V8P 4Z7,,3554 REDWOOD,1204000,1091000,191000,1282000
2023,District of Oak Bay,16-6222-00,V8S 2V6,,2010 RUNNYMEDE,1823000,1660000,284000,1944000
2023,District of Oak Bay,16-6223-00,V8S 2V6,,2006 RUNNYMEDE,1873000,1743000,278000,2021000
2023,District of Oak Bay,16-6225-00,V8S 2K7,,190 SUNNY,2014000,1939000,456000,2395000
2023,District of Oak Bay,16-6226-00,V8S 4L2,,362 SUNSET,1840000,1713000,480000,2193000
2023,District of Oak Bay,16-6227-00,V8S 2K5,,130 PRINCE ANDREW,2849000,2600000,725000,3325000
2023,District of Oak Bay,16-6228-00,V8S 2K5,,150 PRINCE ANDREW,2237000,2221000,456000,2677000
2023,District of Oak Bay,16-6229-00,V8S 2K5,,170 PRINCE ANDREW,3606000,2366000,1712000,4078000
2023,District of Oak Bay,16-6232-00,V8S 4J1,,1000 FOUL BAY,1158700,1158000,101000,1259000
2023,District of Oak Bay,16-6233-00,V8S 4J1,,980 FOUL BAY,1316000,1202000,204000,1406000
2023,District of Oak Bay,16-6234-00,V8S 5G4,,911 DEAL,1365000,1329000,136000,1465000
2023,District of Oak Bay,16-6235-00,V8S 5G4,,909 DEAL,1396000,1326000,178000,1504000
2023,District of Oak Bay,16-6236-00,V8S 5G4,,907 DEAL,1398000,1363000,131000,1494000
2023,District of Oak Bay,16-6236-00,K2P 2G2,,907 DEAL,1398000,1363000,131000,1494000
2023,District of Oak Bay,16-6237-00,V8S 5G4,,905 DEAL,1412000,1394000,122000,1516000
2023,District of Oak Bay,16-6239-00,V8S 3A8,,2671 MARGATE,1844000,1559000,446000,2005000
2023,District of Oak Bay,16-6240-00,V8X 5G2,,2446 CADBORO BAY,1219000,1099000,251000,1350000
2023,District of Oak Bay,16-6241-00,V8Y 2X1,,2445 DRYFE,1369000,1235000,281000,1516000
2023,District of Oak Bay,16-6241-00,V9A 7J8,,2445 DRYFE,1369000,1235000,281000,1516000
2023,District of Oak Bay,16-6242-00,V8S 4X1,,1335 OLIVER,1940000,1473000,610000,2083000
2023,District of Oak Bay,16-6243-00,V8S 4X1,,1313 OLIVER,1547000,1473000,178000,1651000
2023,District of Oak Bay,16-6244-00,V8S 4Y4,,1268 ST. PATRICK,1520000,1473000,154000,1627000
2023,District of Oak Bay,16-6245-00,V8S 4Y4,,1334 ST. PATRICK,1493000,1472000,134000,1606000
2023,District of Oak Bay,16-6246-00,V8R 1R3,,2072 MEADOW,1298000,1090000,320000,1410000
2023,District of Oak Bay,16-6247-00,V8R 1R3,,2082 MEADOW,1132000,1069000,168000,1237000
2023,District of Oak Bay,16-6248-00,V8R 1R3,,2092 MEADOW,1147000,1126000,124000,1250000
2023,District of Oak Bay,16-6249-00,V8R 1R3,,2096 MEADOW,1106000,1089000,113000,1202000
2023,District of Oak Bay,16-6250-00,V8R 1R2,,2093 MEADOW,1150800,1148000,99200,1247200
2023,District of Oak Bay,16-6251-00,V8R 1R2,,2083 MEADOW,1177000,1092000,185000,1277000
2023,District of Oak Bay,16-6252-00,V8R 1R2,,2073 MEADOW,1170000,1111000,158000,1269000
2023,District of Oak Bay,16-6253-00,V8S 2J5,,117 BARKLEY,2420000,2380000,542000,2922000
2023,District of Oak Bay,16-6254-00,V8S 2J5,,119 BARKLEY,1999000,1939000,467000,2406000
2023,District of Oak Bay,16-6255-00,V8S 2J5,,123 BARKLEY,1882000,1897000,370000,2267000
2023,District of Oak Bay,16-6256-00,V8R 6E7,,3460 UPPER TERRACE,3383000,2906000,695000,3601000
2023,District of Oak Bay,16-6257-00,V8R 6M1,,3270 BEACH,2982000,2889000,303000,3192000
2023,District of Oak Bay,16-6258-00,V8R 6H7,,3285 EXETER,2414000,2168000,405000,2573000
2023,District of Oak Bay,16-6260-00,V8R 2W4,,2790 THORPE,3465000,3456000,217000,3673000
2023,District of Oak Bay,16-6260-00,V8S 1T1,,2790 THORPE,3465000,3456000,217000,3673000
2023,District of Oak Bay,16-6260-00,V0R 2W2,,2790 THORPE,3465000,3456000,217000,3673000
2023,District of Oak Bay,16-6261-00,V8P 4G8,,1476 BEACH,6390000,4005000,3032000,7037000
2023,District of Oak Bay,16-6265-00,V8P 1S3,,2097 RENFREW,1437000,1217000,280000,1497000
2023,District of Oak Bay,16-6266-00,V8T 5J3,,3438 CARDIFF,1500000,1309000,250000,1559000
2023,District of Oak Bay,16-6272-00,V8V 3K2,,1178 BEACH,14253000,7882000,7801000,15683000
2023,District of Oak Bay,16-6275-00,V8X 4Y9,,2707 ESTEVAN,6984000,3256000,4397000,7653000
2023,District of Oak Bay,16-6276-00,V8W 2S6,, KENDAL,3914000,2754000,1733000,4487000
2023,District of Oak Bay,16-6277-00,V8P 1R8,,2016 KENDAL,1239900,1187000,100000,1287000
2023,District of Oak Bay,16-6278-00,V8S 2Z7,,2091 STONEHEWER,1561000,1440000,235000,1675000
2023,District of Oak Bay,16-6279-00,V8S 2J8,,1319 NEWPORT,5776000,2501000,3442000,5943000
2023,District of Oak Bay,16-6280-00,V8V 3K2,,2151 HAULTAIN,8791000,4697000,4975000,9672000
2023,District of Oak Bay,16-6281-00,V6N 1Y2,,1927 GREATFORD,1773000,1723000,211000,1934000
2023,District of Oak Bay,16-6282-00,V8R 6N1,,1931 BOWKER,2245000,2124000,327000,2451000
2023,District of Oak Bay,16-6283-00,V8P 4Z2,,3541 CARDIFF,1466000,1248000,275000,1523000
2023,District of Oak Bay,16-6284-00,V8P 4Z2,,3545 CARDIFF,1386000,1206000,242000,1448000
2023,District of Oak Bay,16-6285-00,V8P 4Z2,,3547 CARDIFF,1274000,1194000,127000,1321000
2023,District of Oak Bay,16-6286-00,V8P 4Z2,,3549 CARDIFF,1247000,1166000,125000,1291000
2023,District of Oak Bay,16-6286-00,V8R 5E7,,3549 CARDIFF,1247000,1166000,125000,1291000
2023,District of Oak Bay,16-6287-00,V8P 4Z2,,3553 CARDIFF,1279000,1184000,135000,1319000
2023,District of Oak Bay,16-6288-00,V3S 4H1,,2073 FREDERICK NORRIS,1255000,1161000,140000,1301000
2023,District of Oak Bay,16-6289-00,V8P 4Z4,,3542 CARDIFF,1300000,1220000,127000,1347000
2023,District of Oak Bay,16-6290-00,V8P 4Z4,,3544 CARDIFF,1588000,1234000,460000,1694000
2023,District of Oak Bay,16-6291-00,V8P 4Z4,,3548 CARDIFF,1400000,1242000,205000,1447000
2023,District of Oak Bay,16-6292-00,V8P 1Y5,,2047 SWANSON,1683000,1426000,323000,1749000
2023,District of Oak Bay,16-6293-00,V8P 1Y5,,2043 SWANSON,1533000,1302000,305000,1607000
2023,District of Oak Bay,16-6294-00,V8P 1Y5,,2041 SWANSON,1358000,1192000,226000,1418000
2023,District of Oak Bay,16-6295-00,V8P 1Y6,,2050 SWANSON,1327000,1163000,223000,1386000
2023,District of Oak Bay,16-6296-00,V8P 1Y6,,2052 SWANSON,1443000,1234000,277000,1511000
2023,District of Oak Bay,16-6297-00,V8P 1Y6,,2056 SWANSON,1490000,1193000,377000,1570000
2023,District of Oak Bay,16-6298-00,V8P 4Z5,,3550 CARDIFF,1442000,1283000,228000,1511000
2023,District of Oak Bay,16-6299-00,V8P 4Z5,,3554 CARDIFF,1407000,1270000,191000,1461000
2023,District of Oak Bay,16-6300-00,V8P 2B4,,2063 FREDERICK NORRIS,1330000,1219000,159000,1378000
2023,District of Oak Bay,16-6301-00,V8P 2B4,,2053 FREDERICK NORRIS,1379000,1227000,198000,1425000
2023,District of Oak Bay,16-6302-00,J4Z 1P3,,3559 KELSEY,1225000,1145000,127000,1272000
2023,District of Oak Bay,16-6303-00,V8P 4Y1,,3557 KELSEY,1487000,1135000,447000,1582000
2023,District of Oak Bay,16-6304-00,V8P 4Y1,,3553 KELSEY,1230000,1148000,434000,1582000
2023,District of Oak Bay,16-6305-00,V8K 1A2,,3552 KELSEY,1372000,1098000,335000,1433000
2023,District of Oak Bay,16-6306-00,V8R 6H7,,3554 KELSEY,1382000,1075000,374000,1449000
2023,District of Oak Bay,16-6307-00,V8P 4X9,,3556 KELSEY,1325000,1121000,338000,1459000
2023,District of Oak Bay,16-6308-00,V8P 4X9,,3558 KELSEY,1243000,1095000,199000,1294000
2023,District of Oak Bay,16-6309-00,V8P 2B3,,2043 FREDERICK NORRIS,1100000,1026000,137000,1163000
2023,District of Oak Bay,16-6310-00,V8P 4Z7,,3566 REDWOOD,1225000,1030000,241000,1271000
2023,District of Oak Bay,16-6311-00,V8P 4Z7,,3564 REDWOOD,1188000,1040000,207000,1247000
2023,District of Oak Bay,16-6311-00,V8P 4Z7,,3564 REDWOOD,1188000,1040000,207000,1247000
2023,District of Oak Bay,16-6312-00,V8P 4Z7,,3562 REDWOOD,1298000,1066000,289000,1355000
2023,District of Oak Bay,16-6315-00,V8P 4Z7,,3556 REDWOOD,1195000,1104000,134000,1238000
2023,District of Oak Bay,16-6316-00,V8P 4Z8,,3553 REDWOOD,1755000,1223000,601000,1824000
2023,District of Oak Bay,16-6317-00,V8P 4Z8,,3555 REDWOOD,1466000,1191000,350000,1541000
2023,District of Oak Bay,16-6318-00,V8P 4Z8,,3557 REDWOOD,1342000,1156000,248000,1404000
2023,District of Oak Bay,16-6319-00,V5Z 1P9,,2011 RATTENBURY,1744000,1453000,377000,1830000
2023,District of Oak Bay,16-6319-00,V8P 1Y4,,2011 RATTENBURY,1744000,1453000,377000,1830000
2023,District of Oak Bay,16-6320-00,V8P 1Y4,,2007 RATTENBURY,1679000,1425000,324000,1749000
2023,District of Oak Bay,16-6321-00,V8P 1Y3,,2006 RATTENBURY,1735000,1455000,360000,1815000
2023,District of Oak Bay,16-6323-00,V8P 4Z9,,3559 REDWOOD,1233000,1135000,142000,1277000
2023,District of Oak Bay,16-6324-00,V8P 4Z9,,3561 REDWOOD,1417000,1184000,298000,1482000
2023,District of Oak Bay,16-6325-00,V8P 2A9,,2021 PELLY,1298000,1198000,145000,1343000
2023,District of Oak Bay,16-6326-00,V8P 2A9,,2015 PELLY,1430000,1267000,214000,1481000
2023,District of Oak Bay,16-6327-00,V8P 2A9,,2007 PELLY,1395000,1329000,118000,1447000
2023,District of Oak Bay,16-6328-00,V8P 2A9,,2005 PELLY,2180000,1837000,438000,2275000
2023,District of Oak Bay,16-6329-00,V8P 5A1,,3563 REDWOOD,1318000,1199000,171000,1370000
2023,District of Oak Bay,16-6330-00,V8P 2B1,,2031 FREDERICK NORRIS,1458000,1209000,320000,1529000
2023,District of Oak Bay,16-6331-00,V8P 2B2,,2034 FREDERICK NORRIS,1264000,1135000,182000,1317000
2023,District of Oak Bay,16-6332-00,V8P 2B2,,2036 FREDERICK NORRIS,1334000,1218000,165000,1383000
2023,District of Oak Bay,16-6333-00,V8P 2B2,,2040 FREDERICK NORRIS,1391000,1277000,173000,1450000
2023,District of Oak Bay,16-6334-00,T3A 3Z5,,2042 FREDERICK NORRIS,1396000,1299000,152000,1451000
2023,District of Oak Bay,16-6335-00,V8P 2B2,,2044 FREDERICK NORRIS,1494000,1302000,260000,1562000
2023,District of Oak Bay,16-6336-00,V8Z 5N3,,2048 FREDERICK NORRIS,1390000,1306000,130000,1436000
2023,District of Oak Bay,16-6336-00,V8Z 5N3,,2048 FREDERICK NORRIS,1390000,1306000,130000,1436000
2023,District of Oak Bay,16-6337-00,V8P 2B2,,2052 FREDERICK NORRIS,1433000,1289000,202000,1491000
2023,District of Oak Bay,16-6338-00,V8P 2B2,,2056 FREDERICK NORRIS,1328000,1271000,109000,1380000
2023,District of Oak Bay,16-6339-00,V8P 2B2,,2060 FREDERICK NORRIS,1356000,1250000,153000,1403000
2023,District of Oak Bay,16-6340-00,V8P 2B2,,2064 FREDERICK NORRIS,1392000,1229000,217000,1446000
2023,District of Oak Bay,16-6341-00,V8P 2B2,,2066 FREDERICK NORRIS,1630000,1196000,533000,1729000
2023,District of Oak Bay,17-6342-00,V8R 6G7,,3300 RIPON,2803000,2705000,295000,3000000
2023,District of Oak Bay,17-6343-00,V8R 6G7,,3280 RIPON,5177000,3041000,2588000,5629000
2023,District of Oak Bay,17-6344-00,V8S 2N2,,963 BEACH,13670000,6680000,6382000,13062000
2023,District of Oak Bay,17-6345-00,V8S 2N2,,951 BEACH,5900000,5281000,259000,5540000
2023,District of Oak Bay,17-6346-00,V8R 6E7,,3480 UPPER TERRACE,2560000,2702000,52100,2754100
2023,District of Oak Bay,17-6347-00,V8R 6E7,,3470 UPPER TERRACE,2858000,2775000,283000,3058000
2023,District of Oak Bay,17-6348-00,V8S 2M5,,532 BEACH,2605000,2278000,746000,3024000
2023,District of Oak Bay,17-6349-00,V8S 2M5,,540 BEACH,2122000,2200000,287000,2487000
2023,District of Oak Bay,17-6350-00,V8R 6J4,,1857 BEACH,1715000,1611000,264000,1875000
2023,District of Oak Bay,17-6351-00,V8R 6J4,,1881 BEACH,1883000,1625000,453000,2078000
2023,District of Oak Bay,17-6352-00,V8R 6J4,,1891 BEACH,1757000,1672000,248000,1920000
2023,District of Oak Bay,17-6354-00,V8S 3A3,,2517 MARGATE,1290400,1325000,64500,1389500
2023,District of Oak Bay,17-6355-00,V8S 3A3,,2525 MARGATE,1878000,1326000,657000,1983000
2023,District of Oak Bay,17-6356-00,V8S 3A3,,2533 MARGATE,1301000,1326000,75000,1401000
2023,District of Oak Bay,17-6357-00,V8P 1Y3,,2010 RATTENBURY,1994000,1753000,334000,2087000
2023,District of Oak Bay,17-6358-00,V8P 1Y3,,2012 RATTENBURY,2455000,1793000,813000,2606000
2023,District of Oak Bay,17-6360-00,V8S 2G9,,1961 CRESCENT,2722900,2469000,93800,2562800
2023,District of Oak Bay,17-6361-00,V8W 3G3,,1420 BEACH,29948000,6523000,26382000,32905000
2023,District of Oak Bay,17-6362-00,V8S 4H8,, FOUL BAY,20700,22200,0,22200
2023,District of Oak Bay,17-6363-00,V8S 4H8,,932 FOUL BAY,1084000,934000,236000,1170000
2023,District of Oak Bay,17-6364-00,V8S 4H8,,934 FOUL BAY,1477000,1177000,429000,1606000
2023,District of Oak Bay,17-6367-01,V8W 3N7,,3800 FINNERTY,376063000,84496000,326330000,410826000
2023,District of Oak Bay,17-6368-00,V8S 4H6,,839 FOUL BAY,1441000,1291000,267000,1558000
2023,District of Oak Bay,17-6369-00,V8S 4H6,,831 FOUL BAY,1632000,1276000,505000,1781000
2023,District of Oak Bay,17-6370-00,V8S 4H6,,825 FOUL BAY,2846000,2300000,906000,3206000
2023,District of Oak Bay,17-6371-00,T3A 4Y2,, FOUL BAY,115000,124000,0,124000
2023,District of Oak Bay,17-6372-00,V8S 2P2,,2187 LAFAYETTE,1295800,1301000,91900,1392900
2023,District of Oak Bay,17-6374-01,V8S 2P2,,2189 LAFAYETTE,2199000,1639000,807000,2446000
2023,District of Oak Bay,17-6374-02,V8S 2P2,,2191 LAFAYETTE,2612000,1602000,1325000,2927000
2023,District of Oak Bay,17-6374-03,V8S 2P2,,2193 LAFAYETTE,2185000,1629000,820000,2449000
2023,District of Oak Bay,17-6374-04,V8S 2P2,,2195 LAFAYETTE,2628000,1551000,1384000,2935000
2023,District of Oak Bay,17-6375-00,V8S 2J9,,40 KING GEORGE,1840000,1817000,400000,2217000
2023,District of Oak Bay,17-6376-00,V8S 4K3,,190 DENISON,2158000,2050000,559000,2609000
2023,District of Oak Bay,17-6378-00,V8S 2H8,,2140 LORNE,2841000,1763000,1299000,3062000
2023,District of Oak Bay,17-6379-00,V8S 2H8,,2200 LORNE,1929000,1801000,280000,2081000
2023,District of Oak Bay,17-6380-00,V8R 1G2,, KING GEORGE,508000,594000,0,594000
2023,District of Oak Bay,17-6381-00,V0R 2Z0,,2128 LORNE,1817000,1772000,182000,1954000
2023,District of Oak Bay,17-6383-00,V8S 2G4,,975 BRIGHTON,648700,630000,67100,697100
2023,District of Oak Bay,17-6384-00,V8S 4H8,,944 FOUL BAY,1485000,1245000,346000,1591000
2023,District of Oak Bay,17-6386-10,V8R 5N4,,1616 YALE,1818000,1016000,1056000,2072000
2023,District of Oak Bay,17-6386-20,V8R 5N4,,1624 YALE,1835000,1011000,1081000,2092000
2023,District of Oak Bay,17-6386-30,V8R 5N4,,1632 YALE,1855000,1051000,1030000,2081000
2023,District of Oak Bay,17-6387-00,V8S 4X5,,848 ST. PATRICK,1455000,1286000,282000,1568000
2023,District of Oak Bay,17-6388-00,V8S 4X5,,836 ST. PATRICK,1338000,1285000,150000,1435000
2023,District of Oak Bay,17-6389-00,,,915 ISLAND,1995000,1693000,475000,2168000
2023,District of Oak Bay,17-6390-00,V8S 5B1,,877 BYNG,2826000,1479000,1687000,3166000
2023,District of Oak Bay,17-6391-00,V8S 5B1,,853 BYNG,2052000,1542000,679000,2221000
2023,District of Oak Bay,17-6392-00,V8P 2B1,,2027 FREDERICK NORRIS,1476000,1219000,325000,1544000
2023,District of Oak Bay,17-6393-00,V8P 2B1,,2023 FREDERICK NORRIS,1467000,1220000,316000,1536000
2023,District of Oak Bay,17-6394-00,V8P 2B1,,2019 FREDERICK NORRIS,1452000,1205000,319000,1524000
2023,District of Oak Bay,17-6405-00,V8P 2R5,,2035 CEDAR HILL CROSS,1199000,1105000,137000,1242000
2023,District of Oak Bay,17-6406-00,V8P 2R5,,2039 CEDAR HILL CROSS,1228000,1105000,158000,1263000
2023,District of Oak Bay,17-6407-00,V8P 2R5,,2041 CEDAR HILL CROSS,1243000,1105000,190000,1295000
2023,District of Oak Bay,17-6408-00,V8P 2R5,,2045 CEDAR HILL CROSS,1198000,1105000,135000,1240000
2023,District of Oak Bay,17-6409-00,V8S 4E6,,2049 CEDAR HILL CROSS,1207000,1105000,150000,1255000
2023,District of Oak Bay,17-6410-00,V8P 2R5,,2053 CEDAR HILL CROSS,1243000,1134000,153000,1287000
2023,District of Oak Bay,17-6411-00,V8Z 0B3,,2057 CEDAR HILL CROSS,1214000,1135000,125000,1260000
2023,District of Oak Bay,17-6412-00,V8P 2R5,,2061 CEDAR HILL CROSS,1399000,1120000,351000,1471000
2023,District of Oak Bay,17-6412-00,V8P 2R5,,2061 CEDAR HILL CROSS,1399000,1120000,351000,1471000
2023,District of Oak Bay,17-6413-00,V8P 2R5,,2065 CEDAR HILL CROSS,1337000,1119000,278000,1397000
2023,District of Oak Bay,17-6414-00,V8P 2R5,,2067 CEDAR HILL CROSS,1235000,1103000,182000,1285000
2023,District of Oak Bay,17-6416-00,V8V 3V7,,1701 ELGIN,2655000,2188000,858000,3046000
2023,District of Oak Bay,17-6419-00,V8R 3J7,,1798 ELGIN,1074000,982000,180000,1162000
2023,District of Oak Bay,17-6420-00,V8R 1N9,,2090 MILTON,1205000,1050000,300000,1350000
2023,District of Oak Bay,17-6421-00,V8R 5L9,,1788 ELGIN,1025000,997000,118000,1115000
2023,District of Oak Bay,17-6422-00,V8R 5J9,,2856 CADBORO BAY,1446000,1434000,154000,1588000
2023,District of Oak Bay,17-6423-00,V8S 2J8,,176 BARKLEY,1763000,2141000,0,2141000
2023,District of Oak Bay,17-6424-00,V8S 2J6,,182 BARKLEY,1762000,2128000,10000,2138000
2023,District of Oak Bay,17-6425-00,V8S 4M9,,593 VICTORIA,1357000,1193000,277000,1470000
2023,District of Oak Bay,17-6426-00,V8S 2P6,,2160 GUERNSEY,1301000,1193000,198000,1391000
2023,District of Oak Bay,17-6427-00,V8R 5K4,,3325 CADBORO BAY,3117000,2292000,1201000,3493000
2023,District of Oak Bay,17-6428-00,V8R 5K4,,3355 CADBORO BAY,2184100,2306000,52400,2358400
2023,District of Oak Bay,17-6429-00,V8S 2J9,,46 KING GEORGE,2216000,1981000,683000,2664000
2023,District of Oak Bay,17-6430-00,V8S 2J9,,50 KING GEORGE,2367000,2416000,432000,2848000
2023,District of Oak Bay,17-6430-00,V8S 2J9,,50 KING GEORGE,2367000,2416000,432000,2848000
2023,District of Oak Bay,17-6431-00,V8R 2E4,,2298 BOWKER,1143000,1052000,190000,1242000
2023,District of Oak Bay,17-6432-00,V8P 2R6,,3569 HENDERSON,1504300,1714000,17700,1731700
2023,District of Oak Bay,17-6433-00,V8R 1G2,, HENDERSON,216000,253000,0,253000
2023,District of Oak Bay,17-6434-00,V8R 1G2,, HENDERSON,358000,412000,0,412000
2023,District of Oak Bay,17-6435-00,V8S 2J8,,45 KING GEORGE,2404000,2193000,707000,2900000
2023,District of Oak Bay,17-6436-00,V8S 5C9,,55 KING GEORGE,2144000,2093000,478000,2571000
2023,District of Oak Bay,17-6437-00,V8S 2J8,,85 KING GEORGE,2851000,2113000,1311000,3424000
2023,District of Oak Bay,17-6438-00,V8S 2H8,,2050 LORNE,1762000,1732000,157000,1889000
2023,District of Oak Bay,17-6439-00,V8S 2H8,,2054 LORNE,1816000,1646000,311000,1957000
2023,District of Oak Bay,17-6440-00,V8S 2H8,,2048 LORNE,1381000,1309000,174000,1483000
2023,District of Oak Bay,17-6441-00,V8S 2H8,,2044 LORNE,1479000,1396000,194000,1590000
2023,District of Oak Bay,17-6442-00,V8S 4Z1,,1237 ST. DAVID,2247000,1475000,938000,2413000
2023,District of Oak Bay,17-6443-00,V8S 4Z1,,1245 ST. DAVID,1540000,1390000,279000,1669000
2023,District of Oak Bay,17-6444-00,V8R 6E7,,3520 UPPER TERRACE,1873000,1620000,367000,1987000
2023,District of Oak Bay,17-6445-00,V8S 4M7,,449 VICTORIA,1478000,1356000,233000,1589000
2023,District of Oak Bay,17-6446-00,V8P 5J2,,1950 LANSDOWNE,2248100,2564000,28200,2592200
2023,District of Oak Bay,17-6450-00,V8P 2B1,,2015 FREDERICK NORRIS,1440000,1204000,308000,1512000
2023,District of Oak Bay,17-6451-00,V8P 2B1,,2011 FREDERICK NORRIS,1458000,1200000,326000,1526000
2023,District of Oak Bay,17-6452-00,V8P 2B1,,2005 FREDERICK NORRIS,1423000,1147000,345000,1492000
2023,District of Oak Bay,17-6453-00,V8P 2B2,,2008 FREDERICK NORRIS,1434000,1221000,286000,1507000
2023,District of Oak Bay,17-6454-00,V8P 2B2,,2012 FREDERICK NORRIS,1293000,1062000,297000,1359000
2023,District of Oak Bay,17-6455-00,V8P 2B2,,2016 FREDERICK NORRIS,1361000,1100000,335000,1435000
2023,District of Oak Bay,17-6456-00,V8P 2B2,,2020 FREDERICK NORRIS,1606000,1184000,514000,1698000
2023,District of Oak Bay,17-6457-00,V8X 5E3,,2025 CEDAR HILL CROSS,1163000,1043000,165000,1208000
2023,District of Oak Bay,17-6458-00,V8P 2B2,,2024 FREDERICK NORRIS,1347000,1131000,284000,1415000
2023,District of Oak Bay,17-6459-00,V8P 2R5,,2029 CEDAR HILL CROSS,1207000,1043000,231000,1274000
2023,District of Oak Bay,17-6460-00,V8P 2B2,,2028 FREDERICK NORRIS,1399000,1141000,336000,1477000
2023,District of Oak Bay,17-6461-00,V8P 2R5,,2033 CEDAR HILL CROSS,1209000,1113000,141000,1254000
2023,District of Oak Bay,17-6462-00,V8R 1G2,, CEDAR HILL CROSS,142000,164000,0,164000
2023,District of Oak Bay,17-6463-00,V8S 2J9,,100 KING GEORGE,1976000,1961000,392000,2353000
2023,District of Oak Bay,17-6465-00,V8S 2J5,,127 BARKLEY,3068000,1964000,1773000,3737000
2023,District of Oak Bay,17-6466-00,V8S 2J5,,131 BARKLEY,1945000,2013000,328000,2341000
2023,District of Oak Bay,17-6467-00,V8S 2H1,,1926 CRESCENT,2343000,2197000,556000,2753000
2023,District of Oak Bay,17-6469-00,V8R 5K8,,3656 CADBORO BAY,1938000,1796000,274000,2070000
2023,District of Oak Bay,17-6470-00,V8R 5K8,,3650 CADBORO BAY,2541000,2536000,192000,2728000
2023,District of Oak Bay,17-6472-00,V8R 6L6,,3152 BEACH,5902000,3124000,3262000,6386000
2023,District of Oak Bay,17-6475-00,V8R 6J2,,1776 BEACH,2557000,1772000,1067000,2839000
2023,District of Oak Bay,17-6476-00,V8S 2X4,,2370 COOKMAN,1349100,1352000,105000,1457000
2023,District of Oak Bay,17-6476-00,V6Z 2X5,,2370 COOKMAN,1349100,1352000,105000,1457000
2023,District of Oak Bay,17-6477-00,V8S 2X4,,2360 COOKMAN,1392000,1355000,157000,1512000
2023,District of Oak Bay,17-6478-00,V8R 6K7,,2880 BEACH,6917000,2838000,4714000,7552000
2023,District of Oak Bay,17-6479-00,V8S 4K3,,170 DENISON,2754000,2410000,915000,3325000
2023,District of Oak Bay,17-6480-00,V8S 4K3,,180 DENISON,2412000,1961000,954000,2915000
2023,District of Oak Bay,17-6481-00,V9B 6G2,,2020 RUNNYMEDE,1487000,1327000,284000,1611000
2023,District of Oak Bay,17-6481-00,T2E 7A8,,2020 RUNNYMEDE,1487000,1327000,284000,1611000
2023,District of Oak Bay,17-6482-00,V8S 2V6,,2028 RUNNYMEDE,2623000,1999000,817000,2816000
2023,District of Oak Bay,17-6483-00,V8S 2J8,,273 KING GEORGE,5175000,4157000,676000,4833000
2023,District of Oak Bay,17-6486-00,V8S 4H8,,940 FOUL BAY,1759000,1482000,424000,1906000
2023,District of Oak Bay,17-6487-00,V8S 2G4,,969 BRIGHTON,768100,736000,90600,826600
2023,District of Oak Bay,17-6488-00,V8P 1R2,,2174 CADBORO BAY,16056000,9085000,8604000,17689000
2023,District of Oak Bay,17-6489-00,V8V 3K2,,2154 OAK BAY,5212000,3478000,2407000,5885000
2023,District of Oak Bay,17-6490-00,V8P 4Z7,,3560 REDWOOD,1344000,1057000,334000,1391000
2023,District of Oak Bay,17-6491-00,V8P 4Z7,,3558 REDWOOD,1288000,1113000,243000,1356000
2023,District of Oak Bay,17-6492-00,V8R 5L3,,2385 EPWORTH,1175000,1135000,141000,1276000
2023,District of Oak Bay,17-6493-00,V8R 2H1,,2120 FAIR,1582000,1066000,651000,1717000
2023,District of Oak Bay,17-6496-00,V8V 3K2,,2230 CADBORO BAY,9690000,5666000,5007000,10673000
2023,District of Oak Bay,17-6497-01,V8S 1H6,, ,442000,539000,0,539000
2023,District of Oak Bay,17-6498-00,V8S 4K7,, QUEEN ANNE,458000,557000,0,557000
2023,District of Oak Bay,17-6499-00,V8X 5G7,,2065 OAK BAY,8994000,5201000,4702000,9903000
2023,District of Oak Bay,17-6500-00,V8P 5E3,,3553 MURDOCH,1331000,1108000,286000,1394000
2023,District of Oak Bay,17-6501-00,V8P 5B6,,3549 MURDOCH,1314000,1120000,242000,1362000
2023,District of Oak Bay,17-6502-00,V8P 5B6,,3545 MURDOCH,1285000,1093000,257000,1350000
2023,District of Oak Bay,17-6503-00,V8P 5B6,,3541 MURDOCH,1307000,1120000,247000,1367000
2023,District of Oak Bay,17-6504-00,V8P 5B6,,3537 MURDOCH,1479000,1094000,476000,1570000
2023,District of Oak Bay,17-6505-00,V8P 5B6,,3533 MURDOCH,1404000,1132000,337000,1469000
2023,District of Oak Bay,17-6506-00,V8P 2R6,,2121 CEDAR HILL CROSS,4504100,4082000,1095100,5177100
2023,District of Oak Bay,17-6508-00,V8S 4R2,,1434 MITCHELL,1550000,1306000,370000,1676000
2023,District of Oak Bay,17-6509-00,V8S 4Y4,,1456 ST. PATRICK,1549000,1498000,164000,1662000
2023,District of Oak Bay,17-6510-00,V8S 4Y4,,1440 ST. PATRICK,1778000,1488000,438000,1926000
2023,District of Oak Bay,17-6511-00,V8S 4K2,,151 DENISON,2876000,2415000,1076000,3491000
2023,District of Oak Bay,17-6513-00,V8S 4K2,,131 DENISON,2581000,2253000,855000,3108000
2023,District of Oak Bay,17-6514-00,V8T 2C7,,121 DENISON,2873000,2726000,574000,3300000
2023,District of Oak Bay,17-6515-00,V8S 4K2,,111 DENISON,3118000,2922000,729000,3651000
2023,District of Oak Bay,17-6515-20,V8S 4K2,,141 DENISON,2572000,2283000,810000,3093000
2023,District of Oak Bay,17-6517-00,V8S 2Z4,,2492 MCNEILL,1424000,1250000,275000,1525000
2023,District of Oak Bay,17-6518-00,V3T 4E3,,1063 FOUL BAY,22988000,11349000,13947000,25296000
2023,District of Oak Bay,17-6519-00,V8T 4W9,,2056 OAK BAY,10869000,6095000,5877000,11972000
2023,District of Oak Bay,17-6520-00,V8R 1Z5,,2375 CRANMORE,1553000,1383000,304000,1687000
2023,District of Oak Bay,17-6522-00,V8T 4W9,,2233 BOWKER,12428000,7239000,6444000,13683000
2023,District of Oak Bay,17-6524-00,V8R 5S4,,1548 WILMOT,1392000,1318000,200000,1518000
2023,District of Oak Bay,17-6525-00,V8R 5S4,,1550 WILMOT,1683000,1530000,306000,1836000
2023,District of Oak Bay,17-6526-00,V8S 3G4,,2041 GRANITE,1975000,1250000,939000,2189000
2023,District of Oak Bay,17-6527-00,V8R 6H5,,3165 NORFOLK,2405000,2189000,374000,2563000
2023,District of Oak Bay,17-6528-00,V8R 3T1,,3180 HUMBER,7397000,4389000,2947000,7336000
2023,District of Oak Bay,17-6529-00,V8R 3T1,,3190 HUMBER,6229000,5046000,708000,5754000
2023,District of Oak Bay,17-6533-00,V8P 1Y3,,2004 RATTENBURY,1927000,1589000,444000,2033000
2023,District of Oak Bay,17-6534-00,V8P 5A3,,3109 HENDERSON,1479000,1295000,246000,1541000
2023,District of Oak Bay,17-6536-00,V8W 2S6,,2251 CADBORO BAY,5953000,5456000,1295000,6751000
2023,District of Oak Bay,17-6537-00,V8S 4K3,,202 DENISON,2540000,2068000,835000,2903000
2023,District of Oak Bay,17-6538-00,V8S 4K3,,198 DENISON,2739000,2133000,1009000,3142000
2023,District of Oak Bay,17-6541-00,V8T 2C7,,2025 OAK BAY,8810000,4770000,6367000,11137000
2023,District of Oak Bay,17-6543-00,V8S 2J6,,188 BARKLEY,1967000,1824000,527000,2351000
2023,District of Oak Bay,17-6544-00,V8R 5T4,,1655 HAMPSHIRE,1638000,1383000,356000,1739000
2023,District of Oak Bay,17-6545-00,V8S 4X1,,1391 OLIVER,2050000,1707000,517000,2224000
2023,District of Oak Bay,17-6546-00,V8S 4X1,,1371 OLIVER,1705000,1446000,362000,1808000
2023,District of Oak Bay,17-6549-00,V8S 3H2,,2470 BERESFORD,2609000,1638000,1321000,2959000
2023,District of Oak Bay,17-6550-00,V8S 3H2,,2460 BERESFORD,2756000,1775000,1362000,3137000
2023,District of Oak Bay,17-6553-00,V8R 3S2,,2440 COTSWOLD,1746300,1818000,49400,1867400
2023,District of Oak Bay,17-6554-00,V8R 3S2,,2450 COTSWOLD,2034300,2133000,38500,2171500
2023,District of Oak Bay,17-6555-00,V8S 2J8,,309 KING GEORGE,2063800,1829000,93300,1922300
2023,District of Oak Bay,17-6556-00,V8S 2J8,,315 KING GEORGE,2212000,1864000,150000,2014000
2023,District of Oak Bay,17-6557-00,V8S 2N1,,1120 BEACH,21312000,13141000,10310000,23451000
2023,District of Oak Bay,17-6559-00,V8S 4G6,,313 FOUL BAY,1703000,1732000,309000,2041000
2023,District of Oak Bay,17-6560-00,V8S 4G6,,325 FOUL BAY,1470000,1533000,222000,1755000
2023,District of Oak Bay,17-6561-00,V8S 4G6,,321 FOUL BAY,1807000,1677000,471000,2148000
2023,District of Oak Bay,17-6562-00,V8S 4G6,,319 FOUL BAY,1401000,1535000,146000,1681000
2023,District of Oak Bay,17-6563-00,V8R 1N8,,2075 MILTON,12139000,7832000,5493000,13325000
2023,District of Oak Bay,17-6564-00,V8S 4K7,, QUEEN ANNE,84100,102000,0,102000
2023,District of Oak Bay,17-6565-00,V8S 4K7,, MOUNTJOY,109000,133000,0,133000
2023,District of Oak Bay,17-6568-01,V8R 1E3,,2021 BRIGHTON,1209000,1296000,331000,1627000
2023,District of Oak Bay,17-6568-01,V8S 4K2,,2021 BRIGHTON,1209000,1296000,331000,1627000
2023,District of Oak Bay,17-6568-01,V9A 1K9,,2021 BRIGHTON,1209000,1296000,331000,1627000
2023,District of Oak Bay,17-6568-02,V8V 0E1,,2031 BRIGHTON,1240000,1295000,1284000,2579000
2023,District of Oak Bay,17-6569-00,V8S 2E5,,2041 BRIGHTON,2585000,1855000,1009000,2864000
2023,District of Oak Bay,17-6570-00,V8S 4G6,,317 FOUL BAY,1980000,2020000,360000,2380000
2023,District of Oak Bay,17-6571-00,V9B 0A6,,2590 CADBORO BAY,3745000,2236000,1590000,3826000
2023,District of Oak Bay,17-6572-01,V8S 4P7,,1182 HEWLETT,1766000,1414000,506000,1920000
2023,District of Oak Bay,17-6573-00,V8S 4P7,,1174 HEWLETT,1306000,1143000,289000,1432000
2023,District of Oak Bay,17-6575-00,V8S 5C5,,486 NEWPORT,3207000,2922000,904000,3826000
2023,District of Oak Bay,17-6576-00,V8S 4K3,,194 DENISON,2346000,2087000,740000,2827000
2023,District of Oak Bay,17-6577-00,V8S 5H6,,969 PATTULLO,2246000,1486000,1041000,2527000
2023,District of Oak Bay,17-6578-00,V8S 3K4,,991 NEWPORT,1693000,1488000,346000,1834000
2023,District of Oak Bay,17-6579-00,V8S 5H6,,965 PATTULLO,1952000,1563000,570000,2133000
2023,District of Oak Bay,17-6580-00,V8S 5H6,,961 PATTULLO,2202000,1553000,869000,2422000
2023,District of Oak Bay,17-6581-00,V8S 5H6,,957 PATTULLO,1741000,1501000,370000,1871000
2023,District of Oak Bay,17-6582-00,V8S 5H6,,953 PATTULLO,1825000,1480000,476000,1956000
2023,District of Oak Bay,17-6583-00,V9B 6E5,,949 PATTULLO,3470000,2914000,1174000,4088000
2023,District of Oak Bay,17-6584-00,V8S 5H6,,947 PATTULLO,1635000,1485000,296000,1781000
2023,District of Oak Bay,17-6585-00,V8S 5C8,,921 NEWPORT,2025000,1486000,742000,2228000
2023,District of Oak Bay,17-6586-00,V8S 5C8,,915 NEWPORT,2243000,1847000,811000,2658000
2023,District of Oak Bay,17-6587-00,V8S 4Y5,,1441 ST. PATRICK,1378000,1173000,316000,1489000
2023,District of Oak Bay,17-6588-00,V8S 4Y5,,1431 ST. PATRICK,1248000,1197000,139000,1336000
2023,District of Oak Bay,17-6590-00,V8V 4X3,,2108 OAK BAY,3004400,2970000,48000,3018000
2023,District of Oak Bay,17-6590-00,V8R 5S1,,2108 OAK BAY,3004400,2970000,48000,3018000
2023,District of Oak Bay,17-6592-00,V8R 1G2,,1975 BEE,12210000,4229000,11861000,16090000
2023,District of Oak Bay,17-6596-00,V8R 6M6,,3695 BEACH,1950000,1853000,235000,2088000
2023,District of Oak Bay,17-6597-00,V8R 3T2,,2710 HIBBENS,4110000,3113000,781000,3894000
2023,District of Oak Bay,17-6598-00,V8S 3C2,,2079 WINDSOR,3015000,2147000,1207000,3354000
2023,District of Oak Bay,17-6599-00,V8S 3C2,,2081 WINDSOR,1638000,1588000,172000,1760000
2023,District of Oak Bay,17-6601-00,V8S 3G8,,2167 GRANITE,1675000,1482000,318000,1800000
2023,District of Oak Bay,17-6602-00,V8R 5X7,,528 ISLAND,3671000,4071000,1497000,5568000
2023,District of Oak Bay,17-6603-00,V8P 5J2,, FOUL BAY,1097000,1264000,0,1264000
2023,District of Oak Bay,17-6604-00,V8R 3S8,,2450 CHILTERN,2901000,2698000,381000,3079000
2023,District of Oak Bay,17-6605-00,V8V 3V7,,2928 EASTDOWNE,1586500,1601000,218800,1819800
2023,District of Oak Bay,17-6606-00,V8S 4P7,,1248 HEWLETT,1997000,1497000,659000,2156000
2023,District of Oak Bay,17-6607-00,V8S 4K2,,319 DENISON,2052000,1845000,624000,2469000
2023,District of Oak Bay,17-6608-00,V8S 4K2,,305 DENISON,4228000,3455000,1599000,5054000
2023,District of Oak Bay,17-6609-00,V8R 4X6,,57 BEACH,1152700,1363000,365000,1728000
2023,District of Oak Bay,17-6610-00,V8V 3K2,,2067 CADBORO BAY,4404000,3406000,1091000,4497000
2023,District of Oak Bay,17-6611-00,V8R 3R7,,3155 RUTLAND,8308000,3725000,4520000,8245000
2023,District of Oak Bay,17-6612-00,V8R 3N8,,3140 TARN,5353000,2918000,2291000,5209000
2023,District of Oak Bay,17-6613-00,V8S 2G9,,2025 CRESCENT,2985000,2558000,233000,2791000
2023,District of Oak Bay,17-6614-00,V8S 5A7,,1256 ST. DENIS,2991000,2037000,1214000,3251000
2023,District of Oak Bay,17-6615-00,V8S 5A7,,1250 ST. DENIS,2858000,1912000,1299000,3211000
2023,District of Oak Bay,17-6617-00,V8S 5C1,,510 LINKLEAS,2036000,1937000,497000,2434000
2023,District of Oak Bay,17-6618-00,V8S 2T7,,517 ISLAND,2143000,2015000,561000,2576000
2023,District of Oak Bay,17-6619-00,V8S 2V8,,905 RUNNYMEDE,1856000,1689000,306000,1995000
2023,District of Oak Bay,17-6620-00,V8S 2V8,,885 RUNNYMEDE,2014000,1683000,492000,2175000
2023,District of Oak Bay,17-6621-00,V8S 2H7,,2159 QUIMPER,1800000,1583000,350000,1933000
2023,District of Oak Bay,17-6622-00,V8S 2H7,,2163 QUIMPER,1662000,1584000,199000,1783000
2023,District of Oak Bay,17-6624-00,V4K 5B8,,1976 BEE,15055000,4400000,10675000,15075000
2023,District of Oak Bay,17-6624-01,V8R 1G2,, ,18300,21100,0,21100
2023,District of Oak Bay,17-6626-00,V8S 2G9,,1985 CRESCENT,2539000,2236000,129000,2365000
2023,District of Oak Bay,17-6627-00,V8S 5C1,,622 LINKLEAS,2792000,1929000,1407000,3336000
2023,District of Oak Bay,17-6628-00,V8S 5C1,,600 LINKLEAS,3045000,2675000,953000,3628000
2023,District of Oak Bay,17-6630-00,V8R 5A3,,1715 FOUL BAY,1058000,893000,260000,1153000
2023,District of Oak Bay,17-6631-00,V8R 1N7,,2019 MILTON,1122000,1078000,134000,1212000
2023,District of Oak Bay,17-6632-00,V8S 5J4,,2555 MCNEILL,1786000,1396000,523000,1919000
2023,District of Oak Bay,17-6633-00,V8S 5J4,,2575 MCNEILL,1526000,1271000,385000,1656000
2023,District of Oak Bay,17-6634-00,V8S 4H8,, FOUL BAY,30800,33000,0,33000
2023,District of Oak Bay,17-6635-00,V8R 1G6,,2265 OAK BAY,1553000,918000,901000,1819000
2023,District of Oak Bay,17-6636-00,V8S 4K3,,166 DENISON,2429000,2231000,700000,2931000
2023,District of Oak Bay,17-6637-00,V8S 2J9,,80 KING GEORGE,2576000,1933000,1091000,3024000
2023,District of Oak Bay,17-6639-01,V8X 2A1,,2045 CARRICK,18080000,12765000,6441000,19206000
2023,District of Oak Bay,17-6640-00,V8S 2H8,,2070 LORNE,1341000,1311000,127000,1438000
2023,District of Oak Bay,17-6641-00,V8S 2V5,,2023 RUNNYMEDE,2061000,1534000,725000,2259000
2023,District of Oak Bay,17-6642-00,V8S 2V5,,2025 RUNNYMEDE,1815000,1533000,420000,1953000
2023,District of Oak Bay,17-6643-00,V8S 2V5,,2027 RUNNYMEDE,3846000,3008000,1519000,4527000
2023,District of Oak Bay,17-6647-00,V8R 3S2,,2032 OAK BAY,1217000,1057000,186000,1243000
2023,District of Oak Bay,17-6652-00,V8R 3N6,,3055 VALDEZ,3796000,2297000,1829000,4126000
2023,District of Oak Bay,17-6653-00,V8R 6L2,,3040 BEACH,2633700,2785000,49200,2834200
2023,District of Oak Bay,17-6654-00,V8R 5T6,,1720 HAMPSHIRE,1459000,1229000,369000,1598000
2023,District of Oak Bay,17-6656-00,V8R 1G1,,2036 OAK BAY,5427000,4310000,1433000,5743000
2023,District of Oak Bay,17-6657-00,T2P 5J9,,3175 TARN,6805000,5339000,987000,6326000
2023,District of Oak Bay,17-6658-00,V8R 5T4,,3165 TARN,8342000,5005000,2825000,7830000
2023,District of Oak Bay,17-6660-00,V8R 5C7,,2933 FOUL BAY,947000,903000,152000,1055000
2023,District of Oak Bay,17-6661-00,T2V 2B1,,2935 FOUL BAY,1229000,992000,343000,1335000
2023,District of Oak Bay,17-6664-00,V8P 5N2,,3112 WESSEX,1366000,1001000,448000,1449000
2023,District of Oak Bay,17-6665-00,V8P 5N2,,3104 WESSEX,1519000,1215000,381000,1596000
2023,District of Oak Bay,17-6666-00,V8P 5N2,,3103 WESSEX,1778000,1234000,661000,1895000
2023,District of Oak Bay,17-6667-00,V8P 5N2,,3109 WESSEX,1570000,1201000,437000,1638000
2023,District of Oak Bay,17-6668-00,V8P 5N2,,3115 WESSEX,1749000,1312000,520000,1832000
2023,District of Oak Bay,17-6669-00,V8P 5N2,,3121 WESSEX,1824000,1283000,637000,1920000
2023,District of Oak Bay,17-6670-00,V8P 5N2,,3127 WESSEX,2340000,1267000,1246000,2513000
2023,District of Oak Bay,17-6671-00,V8P 5N2,,3133 WESSEX,1607000,1229000,447000,1676000
2023,District of Oak Bay,17-6672-00,V8P 5N2,,3139 WESSEX,1622000,1208000,518000,1726000
2023,District of Oak Bay,17-6673-00,V8P 5N2,,3145 WESSEX,1487000,1124000,451000,1575000
2023,District of Oak Bay,17-6674-00,V8P 5N2,,3151 WESSEX,1594000,1174000,504000,1678000
2023,District of Oak Bay,17-6675-00,V8P 5N2,,3157 WESSEX,1650000,1194000,639000,1833000
2023,District of Oak Bay,17-6676-00,V8P 5N2,,3169 WESSEX,1708000,1218000,610000,1828000
2023,District of Oak Bay,17-6677-00,V8P 5N2,,3177 WESSEX,1625000,1255000,443000,1698000
2023,District of Oak Bay,17-6678-00,V8P 5N2,,3194 WESSEX,1625000,1209000,488000,1697000
2023,District of Oak Bay,17-6679-00,V8P 5N2,,3188 WESSEX,1639000,1194000,535000,1729000
2023,District of Oak Bay,17-6680-00,V8P 5N2,,3182 WESSEX,1704000,1176000,646000,1822000
2023,District of Oak Bay,17-6681-00,V8P 5N2,,3176 WESSEX,1544000,1194000,404000,1598000
2023,District of Oak Bay,17-6682-00,V8P 5N2,,3170 WESSEX,1439000,1090000,425000,1515000
2023,District of Oak Bay,17-6683-00,V8P 5N2,,3164 WESSEX,1307000,981000,402000,1383000
2023,District of Oak Bay,17-6684-00,V4N 0K5,,3158 WESSEX,1287000,968000,396000,1364000
2023,District of Oak Bay,17-6685-00,V5H 0G4,,3152 WESSEX,1371000,968000,461000,1429000
2023,District of Oak Bay,17-6685-00,V8P 5N2,,3152 WESSEX,1371000,968000,461000,1429000
2023,District of Oak Bay,17-6686-00,V8P 5N2,,3146 WESSEX,1647000,969000,811000,1780000
2023,District of Oak Bay,17-6687-00,V8P 5N2,,3140 WESSEX,1257000,966000,362000,1328000
2023,District of Oak Bay,17-6688-00,V8P 5N2,,3132 WESSEX,1309000,984000,400000,1384000
2023,District of Oak Bay,17-6689-00,,,3126 WESSEX,1283000,1032000,312000,1344000
2023,District of Oak Bay,17-6689-00,L5N 2Z1,,3126 WESSEX,1283000,1032000,312000,1344000
2023,District of Oak Bay,17-6689-00,V4M 0B6,,3126 WESSEX,1283000,1032000,312000,1344000
2023,District of Oak Bay,17-6690-00,V8R 3E3,,3120 WESSEX,1334000,994000,417000,1411000
2023,District of Oak Bay,17-6691-00,V8R 1G2,, WESSEX,103000,106000,0,106000
2023,District of Oak Bay,17-6692-00,V8R 5X2,,1536 YORK,1905000,1734000,340000,2074000
2023,District of Oak Bay,17-6693-00,L4J 1H6,,1520 YORK,2234000,1566000,869000,2435000
2023,District of Oak Bay,17-6694-00,V8R 5X2,,1524 YORK,1738000,1350000,590000,1940000
2023,District of Oak Bay,17-6695-00,V8R 5X2,,1530 YORK,2628000,1864000,1033000,2897000
2023,District of Oak Bay,17-6696-00,V8S 2J3,,25 MAQUINNA,2918800,2645000,51200,2696200
2023,District of Oak Bay,17-6697-00,V8R 1G2,, DOWNES,552000,636000,0,636000
2023,District of Oak Bay,17-6699-00,V8P 5J2,,3100 FOUL BAY,5706000,5172000,297000,5469000
2023,District of Oak Bay,18-6702-00,V8S 2K2,,244 KING GEORGE,2162000,2156000,432000,2588000
2023,District of Oak Bay,18-6703-00,V8S 2K2,,250 KING GEORGE,2561000,2365000,685000,3050000
2023,District of Oak Bay,18-6706-00,V8S 2T6,,592 ISLAND,2685000,2109000,1115000,3224000
2023,District of Oak Bay,18-6707-00,V8S 2T6,,586 ISLAND,1786000,1459000,690000,2149000
2023,District of Oak Bay,18-6709-00,V8S 2T6,,590 ISLAND,1931000,1510000,736000,2246000
2023,District of Oak Bay,18-6710-00,V8S 2T6,,588 ISLAND,1606000,1505000,407000,1912000
2023,District of Oak Bay,18-6711-00,V8S 2N3,,1220 BEACH,1726000,1464000,390000,1854000
2023,District of Oak Bay,18-6712-00,V8S 2N3,,1216 BEACH,2034000,1535000,666000,2201000
2023,District of Oak Bay,18-6716-00,V8R 6C2,,2408 NOTTINGHAM,1557000,1519000,188000,1707000
2023,District of Oak Bay,18-6717-00,V8R 3M1,,2809 BURDICK,2879000,1898000,1340000,3238000
2023,District of Oak Bay,18-6718-00,V8R 6E8,,3475 UPPER TERRACE,5520000,4387000,1850000,6237000
2023,District of Oak Bay,18-6719-00,V8R 6E8,,3455 UPPER TERRACE,5057000,4743000,669000,5412000
2023,District of Oak Bay,18-6720-00,V8R 1G2,, MIDLAND,549000,631000,0,631000
2023,District of Oak Bay,18-6721-00,V8S 4L9,,777 FALKLAND,2158000,2059000,274000,2333000
2023,District of Oak Bay,18-6722-00,V8S 4N3,,772 VICTORIA,1885000,1691000,331000,2022000
2023,District of Oak Bay,18-6725-00,V8W 2R9,,2250 OAK BAY,5402000,3716000,1947000,5663000
2023,District of Oak Bay,18-6726-00,V8X 5G2,,2035 CADBORO BAY,3040000,2582000,523000,3105000
2023,District of Oak Bay,18-6727-00,V8W 2S6,, ,711000,299000,523000,822000
2023,District of Oak Bay,18-6727-00,V9T 6J9,, ,711000,299000,523000,822000
2023,District of Oak Bay,18-6728-00,V6B 6L5,,2314 OAK BAY,8410000,3825000,5430000,9255000
2023,District of Oak Bay,18-6729-00,V8V 3T9,,2326 OAK BAY,1952000,2011000,106000,2117000
2023,District of Oak Bay,18-6730-00,V8S 2J8,,201 KING GEORGE,2486000,2304000,620000,2924000
2023,District of Oak Bay,18-6731-00,V4K 5B8,,1787 ELGIN,2216000,1332000,1112000,2444000
2023,District of Oak Bay,18-6732-00,V8S 2G9,,2009 CRESCENT,3789000,2393000,1386000,3779000
2023,District of Oak Bay,18-6733-00,V8S 2G9,,2011 CRESCENT,3458000,2502000,857000,3359000
2023,District of Oak Bay,18-6734-00,V8S 2H4,,2173 CRESCENT,3728000,2512000,1209000,3721000
2023,District of Oak Bay,18-6735-00,V8S 2H4,,2179 CRESCENT,3731000,2533000,1284000,3817000
2023,District of Oak Bay,18-6736-00,V8S 2M6,,607 BEACH,4128000,2676000,1753000,4429000
2023,District of Oak Bay,18-6737-00,V8S 2M6,,629 BEACH,2876000,1953000,1471000,3424000
2023,District of Oak Bay,18-6738-00,V8S 2K8,,57 SYLVAN,2135000,1864000,803000,2667000
2023,District of Oak Bay,18-6739-00,V8S 2K8,,63 SYLVAN,2896000,2391000,1067000,3458000
2023,District of Oak Bay,18-6740-00,V8R 5J1,,2585 CADBORO BAY,2563000,2256000,361000,2617000
2023,District of Oak Bay,18-6741-00,V8S 2X5,,2470 HAZEL,1711000,1569000,277000,1846000
2023,District of Oak Bay,18-6742-00,V8S 2X5,,2482 HAZEL,1597000,1324000,386000,1710000
2023,District of Oak Bay,18-6743-00,V8V 3K2,,2187 OAK BAY,19265000,9366000,10299000,19665000
2023,District of Oak Bay,18-6744-00,V8R 1G2,, GRANITE,546400,635000,1400,636400
2023,District of Oak Bay,18-6745-00,V8R 6K2,,2387 ESTEVAN,1512000,1327000,326000,1653000
2023,District of Oak Bay,18-6746-00,V8R 5S3,,1539 WILMOT,1383000,1170000,348000,1518000
2023,District of Oak Bay,18-6747-00,V5C 6N5,,2000 CADBORO BAY,6829000,6205000,770000,6975000
2023,District of Oak Bay,18-6748-00,V8P 5R2,,3361 UNIVERSITY WOODS,1948000,1268000,844000,2112000
2023,District of Oak Bay,18-6749-00,V8P 5R2,,3359 UNIVERSITY WOODS,1879000,1265000,766000,2031000
2023,District of Oak Bay,18-6750-00,V8N 2J2,,3357 UNIVERSITY WOODS,1743000,1265000,613000,1878000
2023,District of Oak Bay,18-6750-00,V8P 5A4,,3357 UNIVERSITY WOODS,1743000,1265000,613000,1878000
2023,District of Oak Bay,18-6750-00,V8P 5R2,,3357 UNIVERSITY WOODS,1743000,1265000,613000,1878000
2023,District of Oak Bay,18-6750-00,V8S 2L5,,3357 UNIVERSITY WOODS,1743000,1265000,613000,1878000
2023,District of Oak Bay,18-6751-00,V8P 5R2,,3355 UNIVERSITY WOODS,1754000,1141000,759000,1900000
2023,District of Oak Bay,18-6752-00,V8R 2M4,,3353 UNIVERSITY WOODS,1331000,1376000,0,1376000
2023,District of Oak Bay,18-6753-00,V8M 1S3,,3351 UNIVERSITY WOODS,2244000,1384000,1040000,2424000
2023,District of Oak Bay,18-6753-00,V8P 5R2,,3351 UNIVERSITY WOODS,2244000,1384000,1040000,2424000
2023,District of Oak Bay,18-6754-00,V8P 5R2,,3349 UNIVERSITY WOODS,1872000,1283000,721000,2004000
2023,District of Oak Bay,18-6755-00,V8P 5R2,,3347 UNIVERSITY WOODS,1895000,1265000,794000,2059000
2023,District of Oak Bay,18-6756-00,V8P 5R2,,3345 UNIVERSITY WOODS,1800000,1265000,679000,1944000
2023,District of Oak Bay,18-6757-00,V8P 5R2,,3343 UNIVERSITY WOODS,1853000,1265000,723000,1988000
2023,District of Oak Bay,18-6757-00,V6R 1C5,,3343 UNIVERSITY WOODS,1853000,1265000,723000,1988000
2023,District of Oak Bay,18-6758-00,V8P 5R2,,3341 UNIVERSITY WOODS,1797000,1265000,672000,1937000
2023,District of Oak Bay,18-6759-00,V8P 5R2,,3339 UNIVERSITY WOODS,1962000,1265000,878000,2143000
2023,District of Oak Bay,18-6760-00,V8P 5R2,,3337 UNIVERSITY WOODS,2006000,1265000,934000,2199000
2023,District of Oak Bay,18-6761-00,V8P 5R2,,3335 UNIVERSITY WOODS,1988000,1299000,886000,2185000
2023,District of Oak Bay,18-6762-00,V8P 5P8,,3333 UNIVERSITY WOODS,1612000,1265000,442000,1707000
2023,District of Oak Bay,18-6763-00,V8P 5P9,,3331 UNIVERSITY WOODS,2148000,1395000,781000,2176000
2023,District of Oak Bay,18-6764-00,V8P 5P9,,3329 UNIVERSITY WOODS,1917000,1286000,756000,2042000
2023,District of Oak Bay,18-6765-00,V8P 5P9,,3327 UNIVERSITY WOODS,1982000,1266000,869000,2135000
2023,District of Oak Bay,18-6766-00,V8P 5P9,,3325 UNIVERSITY WOODS,1766000,1265000,616000,1881000
2023,District of Oak Bay,18-6767-00,V8P 5P9,,3323 UNIVERSITY WOODS,2139000,1265000,1096000,2361000
2023,District of Oak Bay,18-6768-00,V8P 5P9,,3321 UNIVERSITY WOODS,1990000,1265000,1037000,2302000
2023,District of Oak Bay,18-6769-00,V8P 5P9,,3319 UNIVERSITY WOODS,1903000,1242000,815000,2057000
2023,District of Oak Bay,18-6770-00,V8P 5P9,,3317 UNIVERSITY WOODS,1894000,1277000,663000,1940000
2023,District of Oak Bay,18-6770-00,V8M 1X6,,3317 UNIVERSITY WOODS,1894000,1277000,663000,1940000
2023,District of Oak Bay,18-6771-00,V8L 5K9,,3315 UNIVERSITY WOODS,1674000,1228000,554000,1782000
2023,District of Oak Bay,18-6772-00,V8P 5P9,,3313 UNIVERSITY WOODS,1764000,1229000,676000,1905000
2023,District of Oak Bay,18-6773-00,V8P 5P9,,3311 UNIVERSITY WOODS,1935000,1200000,895000,2095000
2023,District of Oak Bay,18-6774-00,V8P 5P9,,3309 UNIVERSITY WOODS,2340000,1219000,1175000,2394000
2023,District of Oak Bay,18-6775-00,V8P 5P9,,3307 UNIVERSITY WOODS,1951000,1248000,838000,2086000
2023,District of Oak Bay,18-6776-00,V8P 5P9,,3305 UNIVERSITY WOODS,1971000,1227000,904000,2131000
2023,District of Oak Bay,18-6777-00,V8P 5P9,,3303 UNIVERSITY WOODS,1633000,1165000,499000,1664000
2023,District of Oak Bay,18-6777-00,V5Y 3H5,,3303 UNIVERSITY WOODS,1633000,1165000,499000,1664000
2023,District of Oak Bay,18-6778-00,V8P 5P8,,3306 UNIVERSITY WOODS,1779000,1265000,643000,1908000
2023,District of Oak Bay,18-6779-00,V8P 5R1,,3356 UNIVERSITY WOODS,2078000,1265000,1000000,2265000
2023,District of Oak Bay,18-6780-00,V8P 5R1,,3354 UNIVERSITY WOODS,1712000,1277000,557000,1834000
2023,District of Oak Bay,18-6781-00,V8P 5R1,,3346 UNIVERSITY WOODS,2244000,1295000,1187000,2482000
2023,District of Oak Bay,18-6782-00,V8P 5R1,,3344 UNIVERSITY WOODS,1839000,1265000,714000,1979000
2023,District of Oak Bay,18-6783-00,V8P 5R1,,3342 UNIVERSITY WOODS,1835000,1265000,708000,1973000
2023,District of Oak Bay,18-6784-00,V8P 5R1,,3340 UNIVERSITY WOODS,1911000,1277000,802000,2079000
2023,District of Oak Bay,18-6784-00,V8P 5R1,,3340 UNIVERSITY WOODS,1911000,1277000,802000,2079000
2023,District of Oak Bay,18-6785-00,V8P 5P8,,3326 UNIVERSITY WOODS,2089000,1265000,1030000,2295000
2023,District of Oak Bay,18-6786-00,V8P 5P8,,3322 UNIVERSITY WOODS,2259000,1391000,887000,2278000
2023,District of Oak Bay,18-6787-00,V8P 5P8,,3314 UNIVERSITY WOODS,2041000,1265000,944000,2209000
2023,District of Oak Bay,18-6788-00,V8P 5P8,,3312 UNIVERSITY WOODS,1971000,1285000,854000,2139000
2023,District of Oak Bay,18-6789-00,V8P 5P8,,3310 UNIVERSITY WOODS,1883000,1264000,627000,1891000
2023,District of Oak Bay,18-6790-00,V8P 5P8,,3308 UNIVERSITY WOODS,2023000,1273000,942000,2215000
2023,District of Oak Bay,18-6792-01,V8S 4Z4,,1605 YORK,2668000,2193000,738000,2931000
2023,District of Oak Bay,18-6792-01,V8R 5X1,,1605 YORK,2668000,2193000,738000,2931000
2023,District of Oak Bay,18-6792-02,V8S 4Z4,,1609 YORK,1606000,1758000,0,1758000
2023,District of Oak Bay,18-6793-00,V8R 5X8,,1564 PROSPECT,3005000,1768000,1567000,3335000
2023,District of Oak Bay,18-6794-00,V8R 5X8,,1574 PROSPECT,2420000,1766000,949000,2715000
2023,District of Oak Bay,18-6795-00,V8Y 1P1,,3080 LARKDOWNE,1428000,1129000,378000,1507000
2023,District of Oak Bay,18-6795-00,V8R 5N2,,3080 LARKDOWNE,1428000,1129000,378000,1507000
2023,District of Oak Bay,18-6796-00,V8R 5N2,,3070 LARKDOWNE,1681000,1424000,350000,1774000
2023,District of Oak Bay,18-6797-00,V8R 5X7,,1675 PROSPECT,1645000,1414000,397000,1811000
2023,District of Oak Bay,18-6798-00,V8R 6H8,,1682 BEACH,1764000,1539000,404000,1943000
2023,District of Oak Bay,18-6799-00,V8R 1G3,,2188 OAK BAY,6177000,5462000,847000,6309000
2023,District of Oak Bay,18-6800-00,V8S 4X2,,1376 OLIVER,1616000,1390000,360000,1750000
2023,District of Oak Bay,18-6801-00,V8S 4X2,,1370 OLIVER,1891000,1720000,318000,2038000
2023,District of Oak Bay,18-6803-00,V8S 4K2,,199 DENISON,3563000,2474000,1824000,4298000
2023,District of Oak Bay,18-6805-00,V8S 4M6,,580 VICTORIA,1411000,1237000,291000,1528000
2023,District of Oak Bay,18-6806-00,V8S 4M6,,586 VICTORIA,1405000,1237000,284000,1521000
2023,District of Oak Bay,18-6807-00,V8R 1H2,,2380 OAK BAY,1536000,1164000,539000,1703000
2023,District of Oak Bay,18-6808-00,V8R 6L1,,2975 BEACH,6146000,4847000,885000,5732000
2023,District of Oak Bay,18-6809-00,V8S 4Z4,,545 TRANSIT,2363000,1795000,1018000,2813000
2023,District of Oak Bay,18-6810-00,,,498 BEACH,2366000,1942000,796000,2738000
2023,District of Oak Bay,18-6811-00,V8S 2T9,,984 ISLAND,1409000,1266000,261000,1527000
2023,District of Oak Bay,18-6812-00,V8S 2T9,,974 ISLAND,1488000,1247000,571000,1818000
2023,District of Oak Bay,18-6813-00,V8S 2Z3,,2435 MCNEILL,1717000,1184000,719000,1903000
2023,District of Oak Bay,18-6814-00,V8S 3E4,,2317 WINDSOR,1630000,1199000,555000,1754000
2023,District of Oak Bay,18-6815-00,V8S 3E4,,2327 WINDSOR,1642000,1199000,604000,1803000
2023,District of Oak Bay,18-6816-00,V8R 2W3,,2532 ESPLANADE,3324000,2380000,1230000,3610000
2023,District of Oak Bay,18-6817-00,V8R 2W3,,2540 ESPLANADE,2978000,2406000,837000,3243000
2023,District of Oak Bay,18-6818-00,V8R 5J9,,2832 CADBORO BAY,1698000,1406000,475000,1881000
2023,District of Oak Bay,18-6819-00,V8R 3E6,,2276 NEIL,1112000,1065000,169000,1234000
2023,District of Oak Bay,18-6820-00,V8R 1R7,,2713 SOMASS,2510000,2287000,462000,2749000
2023,District of Oak Bay,18-6821-00,V8R 1R7,,2717 SOMASS,2315000,1574000,573000,2147000
2023,District of Oak Bay,18-6823-00,V8R 3S7,,2440 CARDIGAN,3659000,2581000,1652000,4233000
2023,District of Oak Bay,18-6826-00,V8V 3K2,,1725 BEACH,11695000,5886000,7407000,13293000
2023,District of Oak Bay,18-6826-00,V8V 3K2,,1725 BEACH,11695000,5886000,7407000,13293000
2023,District of Oak Bay,18-6827-00,V8W 2S6,, ,823000,949000,0,949000
2023,District of Oak Bay,18-6828-00,V8S 5G5,,1036 DEAL,1920000,1546000,524000,2070000
2023,District of Oak Bay,18-6829-00,V8S 4X1,,1259 OLIVER,1519000,1387000,241000,1628000
2023,District of Oak Bay,18-6830-00,V8S 4X1,,1249 OLIVER,1629000,1354000,1218000,2572000
2023,District of Oak Bay,18-6832-00,V8S 3B9,,2619 CURRIE,1218000,1139000,265000,1404000
2023,District of Oak Bay,18-6834-00,V8R 5T7,,1721 HAMPSHIRE,2638000,1506000,1472000,2978000
2023,District of Oak Bay,18-6836-00,V8R 1G2,, NEWPORT,495000,573000,0,573000
2023,District of Oak Bay,18-6839-00,V8R 5Z6,,2358 HERON,1626000,1571000,198000,1769000
2023,District of Oak Bay,18-6840-00,V8R 5X4,,1741 MONTEITH,1631000,1565000,211000,1776000
2023,District of Oak Bay,18-6841-00,V8R 6T6,,2649 SHADY,1785000,1284000,726000,2010000
2023,District of Oak Bay,18-6842-00,V8W 2S6,,2425 CURRIE,6915000,1641000,5886000,7527000
2023,District of Oak Bay,18-6843-00,V8S 3B5,,2431 CURRIE,1594000,1319000,418000,1737000
2023,District of Oak Bay,18-6844-00,V8P 5R2,,2041 CADBORO BAY,1210000,862000,374000,1236000
2023,District of Oak Bay,18-6844-00,V8N 6N3,,2041 CADBORO BAY,1210000,862000,374000,1236000
2023,District of Oak Bay,18-6845-00,V8R 1G2,,1442 MONTEREY,6151000,3317000,3320000,6637000
2023,District of Oak Bay,18-6845-00,V8R 1G2,,1442 MONTEREY,6151000,3317000,3320000,6637000
2023,District of Oak Bay,18-6846-00,V8R 5Z6,,2338 HERON,1594000,1415000,334000,1749000
2023,District of Oak Bay,18-6847-00,V8R 5Z6,,2346 HERON,1475000,1420000,193000,1613000
2023,District of Oak Bay,18-6848-00,,,1633 PROSPECT,1907000,1556000,575000,2131000
2023,District of Oak Bay,18-6848-00,,,1633 PROSPECT,1907000,1556000,575000,2131000
2023,District of Oak Bay,18-6849-00,V8R 6H8,,1632 BEACH,1953000,1556000,572000,2128000
2023,District of Oak Bay,18-6851-00,V8R 6H8,,1606 BEACH,2093000,1624000,686000,2310000
2023,District of Oak Bay,18-6852-00,V8S 2G9,,1949 CRESCENT,4374000,2269000,2014000,4283000
2023,District of Oak Bay,18-6853-00,V8S 2J9,,90 KING GEORGE,2379000,2591000,277000,2868000
2023,District of Oak Bay,18-6854-00,V8S 2J9,,84 KING GEORGE,2919000,3124000,372000,3496000
2023,District of Oak Bay,18-6855-00,V8S 4K3,,100 DENISON,3013000,3169000,398000,3567000
2023,District of Oak Bay,18-6856-00,V8R 6L6,,3120 BEACH,5690000,3496000,2675000,6171000
2023,District of Oak Bay,18-6857-00,K9H 4V4,,3100 BEACH,2958000,2828000,1304000,4132000
2023,District of Oak Bay,18-6859-00,V8R 5V6,,1647 MONTEREY,1608000,1384000,371000,1755000
2023,District of Oak Bay,18-6860-00,V8R 5V7,,1779 ST. ANN,1537000,1202000,460000,1662000
2023,District of Oak Bay,18-6861-00,V8R 5V7,,1773 ST. ANN,1451000,1202000,378000,1580000
2023,District of Oak Bay,18-6862-00,V8R 5V7,,1767 ST. ANN,1246000,1202000,173000,1375000
2023,District of Oak Bay,18-6862-00,V8R 5V7,,1767 ST. ANN,1246000,1202000,173000,1375000
2023,District of Oak Bay,18-6863-00,V8S 4W4,,754 OLIVER,1560000,1431000,244000,1675000
2023,District of Oak Bay,18-6864-00,V8S 4W4,,742 OLIVER,1534000,1458000,189000,1647000
2023,District of Oak Bay,18-6867-00,V8S 5G3,,924 DEAL,1984000,1274000,906000,2180000
2023,District of Oak Bay,18-6868-00,V8N 5X8,,916 DEAL,1568000,1268000,438000,1706000
2023,District of Oak Bay,18-6869-00,V8S 3A6,,2641 MARGATE,1418000,1318000,207000,1525000
2023,District of Oak Bay,18-6870-00,V8S 4K8,,687 MOUNTJOY,1911000,1954000,348000,2302000
2023,District of Oak Bay,18-6871-00,V8S 4K8,,683 MOUNTJOY,2688000,1886000,1513000,3399000
2023,District of Oak Bay,18-6872-00,V8S 2M5,,510 BEACH,2516000,2343000,595000,2938000
2023,District of Oak Bay,18-6873-00,V8S 4J9,,2114 MARNE,3877000,2578000,911000,3489000
2023,District of Oak Bay,18-6874-00,V6R 1H5,,1039 BEACH,6618000,5192000,1190000,6382000
2023,District of Oak Bay,18-6875-01,V8R 6H2,,3480 RIPON,9765000,3643000,6248000,9891000
2023,District of Oak Bay,18-6875-01,V8R 6H2,,3480 RIPON,9765000,3643000,6248000,9891000
2023,District of Oak Bay,18-6876-00,V8R 6H8,,1580 BEACH,5567000,3636000,2391000,6027000
2023,District of Oak Bay,18-6877-00,V8R 1G2,, ,1854000,2138000,0,2138000
2023,District of Oak Bay,18-6878-00,V8S 2T6,,568 ISLAND,2020000,1562000,826000,2388000
2023,District of Oak Bay,18-6879-00,V8S 2T6,,570 ISLAND,2469000,1673000,1293000,2966000
2023,District of Oak Bay,18-6880-00,V8S 2T6,,572 ISLAND,3468000,2144000,1964000,4108000
2023,District of Oak Bay,18-6881-00,V8S 2T6,,574 ISLAND,3717000,2277000,1952000,4229000
2023,District of Oak Bay,18-6882-00,V8S 2T6,,576 ISLAND,2369000,1685000,1144000,2829000
2023,District of Oak Bay,18-6883-00,V8S 2T6,,578 ISLAND,2161000,1604000,955000,2559000
2023,District of Oak Bay,18-6884-00,V8S 2M9,,1110 BEACH,10918100,7999900,3908000,11907900
2023,District of Oak Bay,18-6885-00,V8W 1R6,,2144 CRESCENT,2110000,2436000,0,2436000
2023,District of Oak Bay,18-6886-00,V8R 6J3,,1860 BEACH,2131000,1826000,507000,2333000
2023,District of Oak Bay,18-6887-00,V8R 6J3,,1852 BEACH,1962000,1487000,703000,2190000
2023,District of Oak Bay,18-6889-00,X1A 2N2,,2106 MARNE,3804000,2587000,1147000,3734000
2023,District of Oak Bay,18-6890-00,V8S 4J9,,2142 MARNE,3103000,2023000,1019000,3042000
2023,District of Oak Bay,18-6891-00,V8S 4J9,,2132 MARNE,3093000,2735000,195000,2930000
2023,District of Oak Bay,18-6892-00,V8S 4L5,,520 FALKLAND,2646000,2114000,914000,3028000
2023,District of Oak Bay,18-6893-00,V8S 4L5,,552 FALKLAND,2024000,1864000,535000,2399000
2023,District of Oak Bay,18-6894-00,T3Z 2T2,,2072 MARNE,3061000,2399000,516000,2915000
2023,District of Oak Bay,18-6895-00,V8S 2H4,,2157 CRESCENT,4695000,2699000,1869000,4568000
2023,District of Oak Bay,18-6896-02,V8R 6H1,,3475 RIPON,5678000,5483000,520000,6003000
2023,District of Oak Bay,18-6896-02,V8R 6H1,,3475 RIPON,5678000,5483000,520000,6003000
2023,District of Oak Bay,18-6896-03,V8R 6H1,,3475 RIPON,5645000,1767000,3907000,5674000
2023,District of Oak Bay,18-6896-03,V9T 6J9,,3475 RIPON,5645000,1767000,3907000,5674000
2023,District of Oak Bay,18-6897-00,V8S 2H4,,2171 CRESCENT,2740100,2480000,53200,2533200
2023,District of Oak Bay,18-6898-00,V8S 4P9,,1369 MITCHELL,3763000,2911000,1243000,4154000
2023,District of Oak Bay,18-6898-10,V8S 4P9,,2095 GRANITE,1459000,369000,1223000,1592000
2023,District of Oak Bay,18-6898-10,V8S 4P9,,2095 GRANITE,1459000,369000,1223000,1592000
2023,District of Oak Bay,18-6899-00,V8S 2E6,,2086 BRIGHTON,1408000,1239000,257000,1496000
2023,District of Oak Bay,18-6900-00,V8S 2E6,,2090 BRIGHTON,1804000,1239000,727000,1966000
2023,District of Oak Bay,18-6901-00,V8S 2E6,,2094 BRIGHTON,1348000,1276000,202000,1478000
2023,District of Oak Bay,18-6902-00,V8R 5B8,,2751 FOUL BAY,940000,850000,163000,1013000
2023,District of Oak Bay,18-6903-00,V8R 5B8,,2745 FOUL BAY,1471000,850000,771000,1621000
2023,District of Oak Bay,18-6904-00,V8R 5B8,,2741 FOUL BAY,889300,866000,101000,967000
2023,District of Oak Bay,18-6905-00,V8S 2J8,,117 KING GEORGE,2045000,2256000,222000,2478000
2023,District of Oak Bay,18-6906-00,V8S 2H8,,2088 LORNE,2506000,1627000,1165000,2792000
2023,District of Oak Bay,18-6907-00,V8S 2S9,,2465 CENTRAL,1556000,1507000,361000,1868000
2023,District of Oak Bay,18-6908-00,V8S 2S9,,2473 CENTRAL,1881000,1355000,884000,2239000
2023,District of Oak Bay,18-6909-00,V8S 2S9,,2481 CENTRAL,1688000,1512000,501000,2013000
2023,District of Oak Bay,18-6910-00,V8R 5V7,,1733 ST. ANN,1472000,1403000,193000,1596000
2023,District of Oak Bay,18-6911-00,V8R 5V7,,1717 ST. ANN,1397000,1342000,177000,1519000
2023,District of Oak Bay,18-6912-00,V8R 5S2,,3020 EASTDOWNE,1365000,1204000,213000,1417000
2023,District of Oak Bay,18-6913-00,V8R 5S2,,3030 EASTDOWNE,1319000,1130000,253000,1383000
2023,District of Oak Bay,18-6916-01,V8R 5V5,,1644 MONTEREY,1907000,1176000,871000,2047000
2023,District of Oak Bay,18-6917-00,V8S 4X1,,1467 OLIVER,1930000,1320000,803000,2123000
2023,District of Oak Bay,18-6918-00,V8R 1G8,,2315 OAK BAY,1791000,1229000,751000,1980000
2023,District of Oak Bay,18-6919-00,V8S 2N2,,1029 BEACH,7365000,5263000,1660000,6923000
2023,District of Oak Bay,18-6920-00,V8S 5A4,,1197 TRANSIT,2257000,1561000,896000,2457000
2023,District of Oak Bay,18-6921-00,V8S 5A4,,1187 TRANSIT,2217000,1531000,865000,2396000
2023,District of Oak Bay,18-6921-00,V8S 1C7,,1187 TRANSIT,2217000,1531000,865000,2396000
2023,District of Oak Bay,18-6921-00,L0E 1T0,,1187 TRANSIT,2217000,1531000,865000,2396000
2023,District of Oak Bay,18-6923-00,V8S 2J8,,249 KING GEORGE,11630000,4023000,7244000,11267000
2023,District of Oak Bay,18-6924-00,V1G 4E7,,3290 BEACH,4179000,2829000,1039000,3868000
2023,District of Oak Bay,18-6925-00,V8R 6T6,,2655 SHADY,2652000,1839000,1105000,2944000
2023,District of Oak Bay,18-6925-00,V8R 6T6,,2655 SHADY,2652000,1839000,1105000,2944000
2023,District of Oak Bay,18-6926-00,V8R 6J1,,1720 BEACH,2024000,1638000,612000,2250000
2023,District of Oak Bay,18-6935-00,V8R 6E2,,3135 WEALD,3728000,2486000,1476000,3962000
2023,District of Oak Bay,18-6936-00,V8S 5A8,,657 BYNG,1947000,1973000,360000,2333000
2023,District of Oak Bay,18-6937-00,V8S 5C1,,648 LINKLEAS,2818000,1812000,1571000,3383000
2023,District of Oak Bay,18-6938-00,V8S 2J8,,363 KING GEORGE,4174000,2383000,1909000,4292000
2023,District of Oak Bay,18-6939-00,V8S 2J8,,369 KING GEORGE,4709000,2864000,1938000,4802000
2023,District of Oak Bay,18-6940-00,T1S 1A1,,375 KING GEORGE,4301000,2767000,1521000,4288000
2023,District of Oak Bay,18-6941-00,V8S 5B9,,606 INGLEWOOD,2971000,2800000,788000,3588000
2023,District of Oak Bay,18-6942-00,V8S 2M5,,592 BEACH,2194000,2338000,236000,2574000
2023,District of Oak Bay,18-6944-00,V8R 3M6,,2856 DEWDNEY,2066000,1746000,528000,2274000
2023,District of Oak Bay,18-6945-00,V8R 5X7,,1621 PROSPECT,3593000,2394000,1567000,3961000
2023,District of Oak Bay,18-6946-00,V8S 5C8,,843 NEWPORT,2268000,2050000,666000,2716000
2023,District of Oak Bay,18-6948-00,V8J 1A3,,2425 OAK BAY,2131000,1538000,822000,2360000
2023,District of Oak Bay,18-6948-00,V8R 1H3,,2425 OAK BAY,2131000,1538000,822000,2360000
2023,District of Oak Bay,18-6948-00,V5L 4J2,,2425 OAK BAY,2131000,1538000,822000,2360000
2023,District of Oak Bay,18-6948-00,V6E 4L5,,2425 OAK BAY,2131000,1538000,822000,2360000
2023,District of Oak Bay,18-6949-00,V8R 6V9,,2435 OAK BAY,2149000,1519000,836000,2355000
2023,District of Oak Bay,18-6951-00,V8S 2V1,,967 ISLAND,2075000,1471000,766000,2237000
2023,District of Oak Bay,18-6952-00,V8S 2V1,,959 ISLAND,2546000,1476000,1365000,2841000
2023,District of Oak Bay,18-6953-00,V8S 4P3,,1175 VICTORIA,1417000,1367000,155000,1522000
2023,District of Oak Bay,18-6954-00,V1C 1A2,,1155 VICTORIA,2392000,1360000,1283000,2643000
2023,District of Oak Bay,18-6954-00,V8S 4P3,,1155 VICTORIA,2392000,1360000,1283000,2643000
2023,District of Oak Bay,18-6955-00,V8S 4P3,,1149 VICTORIA,1725000,1352000,489000,1841000
2023,District of Oak Bay,18-6956-00,V9A 1M7,,2260 OAK BAY,5339000,3245000,2196000,5441000
2023,District of Oak Bay,18-6957-00,V8S 3H2,,2450 BERESFORD,2277000,1681000,860000,2541000
2023,District of Oak Bay,20-0006-00,T5J 2N7,, ,4406000,0,2192000,2192000
2023,District of Oak Bay,20-0007-00,V6B 5R3,, ,2927000,0,3115000,3115000
2023,District of Oak Bay,20-0008-00,M4Y 2Y5,, ,23100,0,24000,24000
2023,District of Oak Bay,70-0002-00,V8R 1G2,, BEACH,346000,374000,0,374000
2023,District of Oak Bay,70-0002-00,V9T 6J9,, BEACH,346000,374000,0,374000
2023,District of Oak Bay,70-0005-00,V8R 1G2,, BEACH,1604900,1743000,95900,1838900
2023,District of Oak Bay,70-0006-00,V8R 1G2,, BEACH,1011000,1089000,0,1089000
2023,District of Oak Bay,70-0006-00,V9T 6J9,, BEACH,1011000,1089000,0,1089000
2023,District of Oak Bay,70-0007-00,V8R 1G2,, BEACH,214000,234000,0,234000
2023,District of Oak Bay,70-0007-00,V9T 6J9,, BEACH,214000,234000,0,234000
2023,District of Oak Bay,70-0013-00,V6Z 0B9,, ,553000,381000,257000,638000
2023,District of Oak Bay,70-0016-00,V6Z 0B9,, TRIAL,3066700,2648000,509200,3157200
2023,District of Oak Bay,70-0019-00,V8W 2B1,, TRIAL ISLAND,341000,224000,146000,370000
2023,District of Oak Bay,70-0019-00,V9T 6J9,, TRIAL ISLAND,341000,224000,146000,370000
2023,District of Oak Bay,70-0023-00,V8W 2S6,, ,2000,2000,0,2000
2023,District of Oak Bay,70-0023-00,V9T 6J9,, ,2000,2000,0,2000
2023,District of Oak Bay,70-0024-00,V8W 2S6,, ,2000,2000,0,2000
2023,District of Oak Bay,70-0024-00,V9T 6J9,, ,2000,2000,0,2000
2023,District of Oak Bay,70-0026-00,V9T 6J9,,3195 HUMBER,2000,2000,0,2000
2023,District of Oak Bay,70-0026-00,V8R 3S9,,3195 HUMBER,2000,2000,0,2000
2023,District of Oak Bay,80-0001-00,V8S 2N5,106,1312 BEACH,648900,587000,81900,668900
2023,District of Oak Bay,80-0002-00,V8S 2N5,104,1312 BEACH,579900,521000,74300,595300
2023,District of Oak Bay,80-0003-00,V8S 2N5,102,1312 BEACH,535300,476000,74500,550500
2023,District of Oak Bay,80-0004-00,V8S 2N5,101,1312 BEACH,526900,468000,74600,542600
2023,District of Oak Bay,80-0005-00,V8S 2N5,103,1312 BEACH,452800,408000,60500,468500
2023,District of Oak Bay,80-0006-00,V3M 6T9,105,1312 BEACH,371500,334000,53800,387800
2023,District of Oak Bay,80-0007-00,V8S 5A3,107,1312 BEACH,838000,763000,103000,866000
2023,District of Oak Bay,80-0008-00,V8S 2N5,206,1312 BEACH,696000,643000,82800,725800
2023,District of Oak Bay,80-0009-00,V8S 2N5,204,1312 BEACH,651100,608000,76000,684000
2023,District of Oak Bay,80-0010-00,V8S 2N5,202,1312 BEACH,607000,558000,79800,637800
2023,District of Oak Bay,80-0011-00,T2J 4Z8,201,1312 BEACH,558400,501000,78900,579900
2023,District of Oak Bay,80-0012-00,V8S 2N5,203,1312 BEACH,483100,443000,61100,504100
2023,District of Oak Bay,80-0013-00,V8S 2N5,205,1312 BEACH,502300,465000,61100,526100
2023,District of Oak Bay,80-0014-00,T6R 1A6,207,1312 BEACH,892000,819000,103000,922000
2023,District of Oak Bay,80-0015-00,V8S 2N5,306,1312 BEACH,711000,651000,90000,741000
2023,District of Oak Bay,80-0016-00,V8S 2N5,304,1312 BEACH,623700,565000,78300,643300
2023,District of Oak Bay,80-0017-00,V8S 2N5,302,1312 BEACH,575000,495000,99600,594600
2023,District of Oak Bay,80-0018-00,V0N 1G2,301,1312 BEACH,570000,513000,78800,591800
2023,District of Oak Bay,80-0019-00,V8W 0B6,303,1312 BEACH,493100,454000,61000,515000
2023,District of Oak Bay,80-0020-00,V8K 1W9,305,1312 BEACH,513400,476000,61000,537000
2023,District of Oak Bay,80-0020-00,V8K 1W9,305,1312 BEACH,513400,476000,61000,537000
2023,District of Oak Bay,80-0021-00,V8S 2N5,307,1312 BEACH,911000,835000,107000,942000
2023,District of Oak Bay,80-0022-00,V8S 2N5,406,1312 BEACH,731000,672000,94100,766100
2023,District of Oak Bay,80-0023-00,V8S 2N5,404,1312 BEACH,640300,583000,82400,665400
2023,District of Oak Bay,80-0024-00,V8S 2N5,402,1312 BEACH,591800,532000,82500,614500
2023,District of Oak Bay,80-0025-00,V8S 2N5,401,1312 BEACH,586000,529000,82900,611900
2023,District of Oak Bay,80-0026-00,R3M 3X3,403,1312 BEACH,506400,464000,68700,532700
2023,District of Oak Bay,80-0027-00,R3M 3X3,405,1312 BEACH,527900,486000,68700,554700
2023,District of Oak Bay,80-0028-00,V8S 2N5,407,1312 BEACH,936000,862000,111000,973000
2023,District of Oak Bay,80-0029-00,V6J 4H3,A,1400 NEWPORT,5100,4900,200,5100
2023,District of Oak Bay,80-0030-00,T2X 1V2,B,1400 NEWPORT,5100,4900,200,5100
2023,District of Oak Bay,80-0031-00,V8S 5E9,C,1400 NEWPORT,5100,4900,200,5100
2023,District of Oak Bay,80-0032-00,V8S 5E9,D,1400 NEWPORT,5100,4900,200,5100
2023,District of Oak Bay,80-0033-00,V8S 5E9,E,1400 NEWPORT,5100,4900,200,5100
2023,District of Oak Bay,80-0034-00,V8S 5E9,F,1400 NEWPORT,5100,4900,200,5100
2023,District of Oak Bay,80-0035-00,V8S 5E9,13,1400 NEWPORT,5100,4700,300,5000
2023,District of Oak Bay,80-0036-00,V8S 5E9,14,1400 NEWPORT,5100,4700,300,5000
2023,District of Oak Bay,80-0037-00,V8S 5E9,15,1400 NEWPORT,5100,4700,300,5000
2023,District of Oak Bay,80-0038-00,V8S 5E9,16,1400 NEWPORT,5100,4700,300,5000
2023,District of Oak Bay,80-0039-00,V8S 5E9,17,1400 NEWPORT,5100,4700,300,5000
2023,District of Oak Bay,80-0040-00,V8S 5E9,18,1400 NEWPORT,5100,4700,300,5000
2023,District of Oak Bay,80-0040-00,V8S 5E9,18,1400 NEWPORT,5100,4700,300,5000
2023,District of Oak Bay,80-0041-00,V8S 5E9,19,1400 NEWPORT,5100,4700,300,5000
2023,District of Oak Bay,80-0042-00,V8S 5E9,20,1400 NEWPORT,5100,4700,300,5000
2023,District of Oak Bay,80-0043-00,V8S 5E9,21,1400 NEWPORT,5100,4700,300,5000
2023,District of Oak Bay,80-0044-00,V8S 5E9,22,1400 NEWPORT,5100,4700,300,5000
2023,District of Oak Bay,80-0045-00,V8S 5E9,23,1400 NEWPORT,5100,4700,300,5000
2023,District of Oak Bay,80-0046-00,V8S 5E9,24,1400 NEWPORT,5100,4700,300,5000
2023,District of Oak Bay,80-0047-00,V8S 5E9,112,1400 NEWPORT,5100,4700,300,5000
2023,District of Oak Bay,80-0048-00,V8S 5E9,26,1400 NEWPORT,5100,4700,300,5000
2023,District of Oak Bay,80-0049-00,V8S 5E9,12,1400 NEWPORT,5100,5000,80,5080
2023,District of Oak Bay,80-0050-00,V8S 5E9,11,1400 NEWPORT,5100,5000,80,5080
2023,District of Oak Bay,80-0051-00,V8S 5E9,10,1400 NEWPORT,5100,5000,80,5080
2023,District of Oak Bay,80-0052-00,V5L 2L5,9,1400 NEWPORT,5100,5000,80,5080
2023,District of Oak Bay,80-0052-00,V8S 5E9,9,1400 NEWPORT,5100,5000,80,5080
2023,District of Oak Bay,80-0053-00,V8S 5E9,8,1400 NEWPORT,5100,5000,82,5082
2023,District of Oak Bay,80-0054-00,V8S 5E9,7,1400 NEWPORT,5100,5000,80,5080
2023,District of Oak Bay,80-0055-00,V8S 5E9,6,1400 NEWPORT,5100,5000,80,5080
2023,District of Oak Bay,80-0056-00,V8S 5E9,5,1400 NEWPORT,5100,5000,80,5080
2023,District of Oak Bay,80-0057-00,V8S 5E9,115,1400 NEWPORT,5100,5000,80,5080
2023,District of Oak Bay,80-0058-00,V8S 5E9,3,1400 NEWPORT,5100,5000,80,5080
2023,District of Oak Bay,80-0059-00,K7L 2G9,2,1400 NEWPORT,5100,5000,80,5080
2023,District of Oak Bay,80-0060-00,V8S 5E9,1,1400 NEWPORT,5100,5000,80,5080
2023,District of Oak Bay,80-0061-00,V8S 5E9,101,1400 NEWPORT,5100,5000,80,5080
2023,District of Oak Bay,80-0062-00,V8S 5E9,1,1400 NEWPORT,477200,523000,27000,550000
2023,District of Oak Bay,80-0063-00,V8S 5E9,101,1400 NEWPORT,538300,585000,40400,625400
2023,District of Oak Bay,80-0064-00,V8S 5E9,102,1400 NEWPORT,456700,505000,29200,534200
2023,District of Oak Bay,80-0064-00,V5L 2L5,102,1400 NEWPORT,456700,505000,29200,534200
2023,District of Oak Bay,80-0065-00,,103,1400 NEWPORT,321600,360000,20300,380300
2023,District of Oak Bay,80-0066-00,V8S 5E9,104,1400 NEWPORT,349600,391000,21300,412300
2023,District of Oak Bay,80-0067-00,T2X 1V2,105,1400 NEWPORT,349700,391000,21300,412300
2023,District of Oak Bay,80-0068-00,V8S 5E9,106,1400 NEWPORT,352600,394000,21300,415300
2023,District of Oak Bay,80-0069-00,V8S 5E9,107,1400 NEWPORT,351900,394000,20600,414600
2023,District of Oak Bay,80-0070-00,V6J 4H3,108,1400 NEWPORT,355200,396000,22000,418000
2023,District of Oak Bay,80-0071-00,V8S 5E9,109,1400 NEWPORT,458300,504000,29700,533700
2023,District of Oak Bay,80-0072-00,V8S 5E9,110,1400 NEWPORT,370600,409000,22100,431100
2023,District of Oak Bay,80-0073-00,V8S 5E9,111,1400 NEWPORT,333300,371000,18900,389900
2023,District of Oak Bay,80-0074-00,V8S 5E9,112,1400 NEWPORT,388300,431000,24400,455400
2023,District of Oak Bay,80-0075-00,V8S 5E9,113,1400 NEWPORT,321500,359000,21500,380500
2023,District of Oak Bay,80-0076-00,V8S 5E9,114,1400 NEWPORT,466200,511000,30400,541400
2023,District of Oak Bay,80-0077-00,V8S 5E9,115,1400 NEWPORT,474500,519000,31600,550600
2023,District of Oak Bay,80-0078-00,V8S 5E9,201,1400 NEWPORT,574300,626000,41700,667700
2023,District of Oak Bay,80-0079-00,V8S 5E9,202,1400 NEWPORT,478600,528000,31000,559000
2023,District of Oak Bay,80-0080-00,V8S 5E9,203,1400 NEWPORT,328000,367000,20600,387600
2023,District of Oak Bay,80-0081-00,T2V 4R1,204,1400 NEWPORT,360400,402000,22100,424100
2023,District of Oak Bay,80-0082-00,V8S 5E9,205,1400 NEWPORT,356500,398000,22200,420200
2023,District of Oak Bay,80-0083-00,V8S 5E9,206,1400 NEWPORT,361400,403000,22100,425100
2023,District of Oak Bay,80-0084-00,V8S 5E9,207,1400 NEWPORT,360700,403000,21400,424400
2023,District of Oak Bay,80-0085-00,V8S 5E9,208,1400 NEWPORT,366500,408000,23400,431400
2023,District of Oak Bay,80-0086-00,V8S 5E9,209,1400 NEWPORT,465200,511000,30300,541300
2023,District of Oak Bay,80-0087-00,V8S 5E9,210,1400 NEWPORT,382900,423000,23100,446100
2023,District of Oak Bay,80-0088-00,V8S 5E9,211,1400 NEWPORT,362700,400000,22400,422400
2023,District of Oak Bay,80-0091-00,V8S 5E9,214,1400 NEWPORT,478700,524000,31500,555500
2023,District of Oak Bay,80-0092-00,V8S 5E9,215,1400 NEWPORT,484800,530000,32800,562800
2023,District of Oak Bay,80-0093-00,V8S 5E9,301,1400 NEWPORT,614400,677000,43500,720500
2023,District of Oak Bay,80-0094-00,V8S 5E9,302,1400 NEWPORT,511700,570000,31900,601900
2023,District of Oak Bay,80-0095-00,V8S 5E9,303,1400 NEWPORT,336400,379000,21600,400600
2023,District of Oak Bay,80-0096-00,V8S 5E9,304,1400 NEWPORT,371400,417000,22700,439700
2023,District of Oak Bay,80-0097-00,V8S 5E9,305,1400 NEWPORT,366500,412000,22800,434800
2023,District of Oak Bay,80-0097-00,V8S 5E9,305,1400 NEWPORT,366500,412000,22800,434800
2023,District of Oak Bay,80-0098-00,V8S 5E9,306,1400 NEWPORT,370400,416000,22800,438800
2023,District of Oak Bay,80-0099-00,V8S 5E9,307,1400 NEWPORT,369700,416000,22100,438100
2023,District of Oak Bay,80-0100-00,V0R 1X6,308,1400 NEWPORT,377600,424000,24300,448300
2023,District of Oak Bay,80-0101-00,V8S 5E9,309,1400 NEWPORT,475800,527000,31100,558100
2023,District of Oak Bay,80-0102-00,V8S 5E9,310,1400 NEWPORT,394400,436000,24500,460500
2023,District of Oak Bay,80-0103-00,V8S 5E9,311,1400 NEWPORT,371800,413000,23300,436300
2023,District of Oak Bay,80-0104-00,V8S 5E9,312,1400 NEWPORT,411200,458000,26400,484400
2023,District of Oak Bay,80-0105-00,V8S 5E9,313,1400 NEWPORT,333800,374000,22900,396900
2023,District of Oak Bay,80-0106-00,V8S 5E9,314,1400 NEWPORT,533300,592000,33000,625000
2023,District of Oak Bay,80-0107-00,V8S 5E9,315,1400 NEWPORT,519100,573000,34800,607800
2023,District of Oak Bay,80-0108-00,V8R 5J1,101,2535 CADBORO BAY,420200,485000,26200,511200
2023,District of Oak Bay,80-0109-00,V8R 5J1,103,2535 CADBORO BAY,415100,469000,36500,505500
2023,District of Oak Bay,80-0110-00,V8R 5J1,201,2535 CADBORO BAY,440000,497000,39800,536800
2023,District of Oak Bay,80-0111-00,V8R 5J1,203,2535 CADBORO BAY,417300,470000,37700,507700
2023,District of Oak Bay,80-0112-00,V8R 5J1,205,2535 CADBORO BAY,424600,478000,38600,516600
2023,District of Oak Bay,80-0113-00,V8R 5J1,204,2535 CADBORO BAY,343700,390000,30500,420500
2023,District of Oak Bay,80-0114-00,V8R 5J1,202,2535 CADBORO BAY,376700,428000,32600,460600
2023,District of Oak Bay,80-0115-00,V8R 5J1,301,2535 CADBORO BAY,449700,507000,41000,548000
2023,District of Oak Bay,80-0116-00,V8R 5J1,303,2535 CADBORO BAY,426800,480000,38400,518400
2023,District of Oak Bay,80-0117-00,V8R 5J1,305,2535 CADBORO BAY,433400,487000,39700,526700
2023,District of Oak Bay,80-0117-00,T2L 0N7,305,2535 CADBORO BAY,433400,487000,39700,526700
2023,District of Oak Bay,80-0118-00,V8R 5J1,304,2535 CADBORO BAY,351400,397000,32100,429100
2023,District of Oak Bay,80-0119-00,V8R 5J1,302,2535 CADBORO BAY,384200,436000,34200,470200
2023,District of Oak Bay,80-0120-00,V8R 5J1,401,2535 CADBORO BAY,482200,548000,42500,590500
2023,District of Oak Bay,80-0121-00,V8R 5J1,403,2535 CADBORO BAY,456600,518000,40300,558300
2023,District of Oak Bay,80-0122-00,V8R 5J1,405,2535 CADBORO BAY,464300,526000,41600,567600
2023,District of Oak Bay,80-0123-00,V8R 5J1,404,2535 CADBORO BAY,376000,428000,34400,462400
2023,District of Oak Bay,80-0124-00,V8R 5J1,402,2535 CADBORO BAY,411900,470000,36500,506500
2023,District of Oak Bay,80-0125-00,V8Z 5K8,105,2095 OAK BAY,290400,323000,16000,339000
2023,District of Oak Bay,80-0126-00,V8S 2M5,104,2095 OAK BAY,297800,332000,15500,347500
2023,District of Oak Bay,80-0126-00,V8R 1E6,104,2095 OAK BAY,297800,332000,15500,347500
2023,District of Oak Bay,80-0127-00,V8R 1E6,103,2095 OAK BAY,297800,332000,15500,347500
2023,District of Oak Bay,80-0127-00,V8R 1E6,103,2095 OAK BAY,297800,332000,15500,347500
2023,District of Oak Bay,80-0127-00,V8R 1L8,103,2095 OAK BAY,297800,332000,15500,347500
2023,District of Oak Bay,80-0128-00,V8R 1E6,102,2095 OAK BAY,265500,296000,14500,310500
2023,District of Oak Bay,80-0129-00,V8R 1E6,101,2095 OAK BAY,283000,315000,15500,330500
2023,District of Oak Bay,80-0130-00,V8R 1E6,208,2095 OAK BAY,310400,347000,17800,364800
2023,District of Oak Bay,80-0131-00,V8R 1E6,207,2095 OAK BAY,317800,357000,17200,374200
2023,District of Oak Bay,80-0132-00,V8R 1E6,206,2095 OAK BAY,316900,355000,17200,372200
2023,District of Oak Bay,80-0133-00,V8R 1E6,205,2095 OAK BAY,320300,359000,17800,376800
2023,District of Oak Bay,80-0134-00,V8R 1E6,204,2095 OAK BAY,328200,368000,17800,385800
2023,District of Oak Bay,80-0134-00,V0J 3T0,204,2095 OAK BAY,328200,368000,17800,385800
2023,District of Oak Bay,80-0135-00,V8R 1E6,203,2095 OAK BAY,321800,361000,17200,378200
2023,District of Oak Bay,80-0136-00,V8R 1E6,202,2095 OAK BAY,283600,318000,16200,334200
2023,District of Oak Bay,80-0137-00,V8R 1E6,201,2095 OAK BAY,362000,402000,23200,425200
2023,District of Oak Bay,80-0138-00,V8R 1E6,308,2095 OAK BAY,320600,358000,18900,376900
2023,District of Oak Bay,80-0138-00,V8S 5A2,308,2095 OAK BAY,320600,358000,18900,376900
2023,District of Oak Bay,80-0139-00,V8R 1E6,307,2095 OAK BAY,324900,363000,18300,381300
2023,District of Oak Bay,80-0140-00,V8R 1E6,306,2095 OAK BAY,322900,361000,18300,379300
2023,District of Oak Bay,80-0141-00,V8R 1E6,305,2095 OAK BAY,326500,365000,18900,383900
2023,District of Oak Bay,80-0142-00,V8R 1E6,304,2095 OAK BAY,335300,375000,18900,393900
2023,District of Oak Bay,80-0143-00,V8R 1E6,303,2095 OAK BAY,327800,367000,18300,385300
2023,District of Oak Bay,80-0144-00,V8R 1E6,302,2095 OAK BAY,289700,324000,17300,341300
2023,District of Oak Bay,80-0145-00,V8R 1E6,301,2095 OAK BAY,373400,415000,23700,438700
2023,District of Oak Bay,80-0146-00,V8R 1E6,408,2095 OAK BAY,328700,368000,20600,388600
2023,District of Oak Bay,80-0147-00,V8R 1E6,407,2095 OAK BAY,334100,374000,20000,394000
2023,District of Oak Bay,80-0148-00,P6A 6K4,406,2095 OAK BAY,332100,372000,20000,392000
2023,District of Oak Bay,80-0149-00,V8R 1E6,405,2095 OAK BAY,335600,376000,20600,396600
2023,District of Oak Bay,80-0150-00,V8R 1E6,404,2095 OAK BAY,344400,386000,20600,406600
2023,District of Oak Bay,80-0151-00,V8R 1E6,403,2095 OAK BAY,337000,378000,20000,398000
2023,District of Oak Bay,80-0152-00,V8R 1E6,402,2095 OAK BAY,297900,334000,19000,353000
2023,District of Oak Bay,80-0153-00,V8R 1E6,401,2095 OAK BAY,388000,433000,25000,458000
2023,District of Oak Bay,80-0154-00,,103,1440 BEACH,815000,726000,165000,891000
2023,District of Oak Bay,80-0154-00,,103,1440 BEACH,815000,726000,165000,891000
2023,District of Oak Bay,80-0155-00,V8S 2N8,102,1440 BEACH,800000,769000,103000,872000
2023,District of Oak Bay,80-0156-00,V8S 2N8,101,1440 BEACH,846000,808000,114000,922000
2023,District of Oak Bay,80-0157-00,V8S 2N8,107,1440 BEACH,724000,669000,115000,784000
2023,District of Oak Bay,80-0158-00,V8S 2N8,106,1440 BEACH,645600,624000,82000,706000
2023,District of Oak Bay,80-0158-00,V8L 2X9,106,1440 BEACH,645600,624000,82000,706000
2023,District of Oak Bay,80-0159-00,V8S 2N8,105,1440 BEACH,713000,692000,88100,780100
2023,District of Oak Bay,80-0160-00,V8S 2N8,104,1440 BEACH,590400,568000,77700,645700
2023,District of Oak Bay,80-0161-00,V8S 2N8,203,1440 BEACH,1019000,939000,165000,1104000
2023,District of Oak Bay,80-0162-00,V8S 2N8,202,1440 BEACH,811000,776000,105000,881000
2023,District of Oak Bay,80-0163-00,V8S 2N8,201,1440 BEACH,853000,812000,115000,927000
2023,District of Oak Bay,80-0164-00,V8S 2N8,207,1440 BEACH,746000,682000,126000,808000
2023,District of Oak Bay,80-0165-00,V8S 2N8,206,1440 BEACH,653200,627000,84100,711100
2023,District of Oak Bay,80-0166-00,V8S 2N8,205,1440 BEACH,719000,692000,92100,784100
2023,District of Oak Bay,80-0167-00,V8S 2N8,204,1440 BEACH,598200,580000,73600,653600
2023,District of Oak Bay,80-0168-00,V8S 2N8,303,1440 BEACH,1041000,960000,167000,1127000
2023,District of Oak Bay,80-0169-00,V1V 2L9,302,1440 BEACH,828000,792000,107000,899000
2023,District of Oak Bay,80-0170-00,V8S 2N8,301,1440 BEACH,873000,825000,121000,946000
2023,District of Oak Bay,80-0171-00,V8S 2N8,307,1440 BEACH,763000,694000,130000,824000
2023,District of Oak Bay,80-0172-00,V8S 2N8,306,1440 BEACH,666900,632000,93200,725200
2023,District of Oak Bay,80-0173-00,V8S 2N8,305,1440 BEACH,735000,708000,92000,800000
2023,District of Oak Bay,80-0174-00,V8S 2N8,304,1440 BEACH,610900,591000,75500,666500
2023,District of Oak Bay,80-0175-00,V8S 2N8,403,1440 BEACH,1064000,979000,172000,1151000
2023,District of Oak Bay,80-0176-00,V8S 2N8,402,1440 BEACH,847000,806000,111000,917000
2023,District of Oak Bay,80-0177-00,V8S 2N8,401,1440 BEACH,892000,841000,126000,967000
2023,District of Oak Bay,80-0178-00,V8S 2N8,407,1440 BEACH,765000,686000,139000,825000
2023,District of Oak Bay,80-0179-00,V8S 2N8,406,1440 BEACH,681000,643000,97400,740400
2023,District of Oak Bay,80-0180-00,V8S 2N8,405,1440 BEACH,751000,720000,96300,816300
2023,District of Oak Bay,80-0181-00,V8S 2N8,404,1440 BEACH,624200,600000,80200,680200
2023,District of Oak Bay,80-0182-00,V8S 2N8,503,1440 BEACH,1059000,967000,176000,1143000
2023,District of Oak Bay,80-0183-00,V8S 2N8,502,1440 BEACH,870000,829000,119000,948000
2023,District of Oak Bay,80-0184-00,V8S 2N8,501,1440 BEACH,917000,866000,133000,999000
2023,District of Oak Bay,80-0185-00,V8S 2N8,507,1440 BEACH,800000,725000,145000,870000
2023,District of Oak Bay,80-0186-00,V8S 2N8,506,1440 BEACH,700000,663000,102000,765000
2023,District of Oak Bay,80-0186-00,V8X 5E4,506,1440 BEACH,700000,663000,102000,765000
2023,District of Oak Bay,80-0187-00,V8S 2N8,505,1440 BEACH,772000,731000,112000,843000
2023,District of Oak Bay,80-0187-00,V8R 5X4,505,1440 BEACH,772000,731000,112000,843000
2023,District of Oak Bay,80-0188-00,V8S 2N8,504,1440 BEACH,641000,616000,87400,703400
2023,District of Oak Bay,80-0189-00,K7L 2G9,212,1400 NEWPORT,704500,716000,45800,761800
2023,District of Oak Bay,80-0190-00,V8S 2N8,101,1450 BEACH,577300,658000,48400,706400
2023,District of Oak Bay,80-0191-00,V8S 2N8,102,1450 BEACH,337500,379000,29800,408800
2023,District of Oak Bay,80-0192-00,V8S 2N8,103,1450 BEACH,456100,519000,39800,558800
2023,District of Oak Bay,80-0193-00,V8S 2N8,104,1450 BEACH,407900,463000,35500,498500
2023,District of Oak Bay,80-0194-00,V8S 2N8,105,1450 BEACH,456300,516000,42000,558000
2023,District of Oak Bay,80-0195-00,V8S 2N8,106,1450 BEACH,367000,416000,32200,448200
2023,District of Oak Bay,80-0196-00,V8S 2N8,107,1450 BEACH,577400,656000,50700,706700
2023,District of Oak Bay,80-0197-00,V8S 2N8,201,1450 BEACH,619500,705000,49300,754300
2023,District of Oak Bay,80-0198-00,V8S 2N8,202,1450 BEACH,364700,411000,32100,443100
2023,District of Oak Bay,80-0199-00,V8S 2N8,203,1450 BEACH,469000,529000,41700,570700
2023,District of Oak Bay,80-0200-00,V9L 5K4,204,1450 BEACH,455500,510000,42900,552900
2023,District of Oak Bay,80-0201-00,V8S 2N8,205,1450 BEACH,455000,506000,43600,549600
2023,District of Oak Bay,80-0202-00,V8S 2N8,206,1450 BEACH,379400,428000,34300,462300
2023,District of Oak Bay,80-0203-00,V7T 1R1,207,1450 BEACH,619500,703000,51500,754500
2023,District of Oak Bay,80-0204-00,V8S 2N8,208,1450 BEACH,581300,659000,50500,709500
2023,District of Oak Bay,80-0205-00,T3H 3T9,301,1450 BEACH,658800,751000,50300,801300
2023,District of Oak Bay,80-0206-00,V8S 2N8,302,1450 BEACH,387400,438000,33100,471100
2023,District of Oak Bay,80-0207-00,V9S 2N8,303,1450 BEACH,498100,563000,42900,605900
2023,District of Oak Bay,80-0208-00,V8S 2N8,304,1450 BEACH,484200,544000,43800,587800
2023,District of Oak Bay,80-0209-00,V8S 2N8,305,1450 BEACH,498100,561000,44900,605900
2023,District of Oak Bay,80-0210-00,V8S 2N8,306,1450 BEACH,403200,455000,35300,490300
2023,District of Oak Bay,80-0211-00,T2W 5Z7,307,1450 BEACH,658800,749000,51500,800500
2023,District of Oak Bay,80-0212-00,V8S 2N8,308,1450 BEACH,614400,697000,50400,747400
2023,District of Oak Bay,80-0212-00,V9Z 1M9,308,1450 BEACH,614400,697000,50400,747400
2023,District of Oak Bay,80-0213-00,V8S 2N8,401,1450 BEACH,698200,798000,51400,849400
2023,District of Oak Bay,80-0214-00,E2E 4H5,402,1450 BEACH,411200,465000,34200,499200
2023,District of Oak Bay,80-0215-00,V8S 2N8,403,1450 BEACH,528800,598000,43900,641900
2023,District of Oak Bay,80-0216-00,V8K 1X9,404,1450 BEACH,512900,578000,44800,622800
2023,District of Oak Bay,80-0217-00,V8S 2N8,405,1450 BEACH,529100,596000,46000,642000
2023,District of Oak Bay,80-0218-00,V8S 2N8,406,1450 BEACH,428000,484000,36300,520300
2023,District of Oak Bay,80-0219-00,V8S 2N8,407,1450 BEACH,698200,798000,51400,849400
2023,District of Oak Bay,80-0220-00,V8S 2N8,408,1450 BEACH,656100,747000,51600,798600
2023,District of Oak Bay,80-0221-00,V8S 2N8,501,1450 BEACH,1068100,1229000,65200,1294200
2023,District of Oak Bay,80-0222-00,V8S 2N8,502,1450 BEACH,450100,513000,36400,549400
2023,District of Oak Bay,80-0223-00,V8S 2N8,503,1450 BEACH,578200,659000,47300,706300
2023,District of Oak Bay,80-0224-00,V8S 2N8,504,1450 BEACH,562100,637000,48200,685200
2023,District of Oak Bay,80-0225-00,V0L 1G0,505,1450 BEACH,578600,657000,49500,706500
2023,District of Oak Bay,80-0226-00,V8S 2N8,506,1450 BEACH,468400,534000,38700,572700
2023,District of Oak Bay,80-0227-00,V8S 2N8,507,1450 BEACH,977800,1129000,58800,1187800
2023,District of Oak Bay,80-0227-00,V0N 2W2,507,1450 BEACH,977800,1129000,58800,1187800
2023,District of Oak Bay,80-0228-00,V8R 6M6,,1521 CLIVE,433000,443000,90500,533500
2023,District of Oak Bay,80-0229-00,V8R 1G9,,2302 OAK BAY,427900,427000,90700,517700
2023,District of Oak Bay,80-0230-00,V8R 6M6,,2306 OAK BAY,432300,401000,81300,482300
2023,District of Oak Bay,80-0231-00,V8X 3C5,,2310 OAK BAY,447400,448000,93800,541800
2023,District of Oak Bay,80-0232-00,V8S 3G6,111,2100 GRANITE,307900,345000,18800,363800
2023,District of Oak Bay,80-0233-00,V8S 3G7,112,2100 GRANITE,421700,466000,25400,491400
2023,District of Oak Bay,80-0234-00,V8S 3G7,114,2100 GRANITE,330000,369000,19300,388300
2023,District of Oak Bay,80-0235-00,V8S 3G7,101,2100 GRANITE,330100,368000,19400,387400
2023,District of Oak Bay,80-0236-00,V8S 3G7,102,2100 GRANITE,412600,439000,42700,481700
2023,District of Oak Bay,80-0237-00,V8S 3G7,103,2100 GRANITE,331400,370000,19700,389700
2023,District of Oak Bay,80-0238-00,V8S 3G7,104,2100 GRANITE,326500,364000,19700,383700
2023,District of Oak Bay,80-0239-00,V8S 3G7,105,2100 GRANITE,321600,359000,19700,378700
2023,District of Oak Bay,80-0240-00,V8S 3G7,106,2100 GRANITE,411600,453000,27000,480000
2023,District of Oak Bay,80-0241-00,V8S 3G7,107,2100 GRANITE,298300,333000,18800,351800
2023,District of Oak Bay,80-0242-00,V8S 3G7,108,2100 GRANITE,362100,405000,19300,424300
2023,District of Oak Bay,80-0243-00,V8S 3G8,109,2100 GRANITE,325200,363000,19300,382300
2023,District of Oak Bay,80-0244-00,V8S 3G7,110,2100 GRANITE,327100,365000,19300,384300
2023,District of Oak Bay,80-0245-00,V8S 3G7,215,2100 GRANITE,334000,377000,20100,397100
2023,District of Oak Bay,80-0246-00,V8S 3G7,216,2100 GRANITE,449000,500000,26900,526900
2023,District of Oak Bay,80-0247-00,V8S 3G7,217,2100 GRANITE,345400,388000,20700,408700
2023,District of Oak Bay,80-0248-00,V8S 3G7,201,2100 GRANITE,349800,393000,21400,414400
2023,District of Oak Bay,80-0249-00,V8S 3G7,202,2100 GRANITE,439200,488000,29000,517000
2023,District of Oak Bay,80-0249-00,M6R 1M9,202,2100 GRANITE,439200,488000,29000,517000
2023,District of Oak Bay,80-0250-00,V8R 5X7,203,2100 GRANITE,343300,384000,21600,405600
2023,District of Oak Bay,80-0251-00,V8S 3G7,204,2100 GRANITE,345200,387000,21600,408600
2023,District of Oak Bay,80-0252-00,V8S 3G7,205,2100 GRANITE,343300,385000,21600,406600
2023,District of Oak Bay,80-0253-00,V8S 3G7,206,2100 GRANITE,346100,388000,21600,409600
2023,District of Oak Bay,80-0254-00,V8S 3G7,207,2100 GRANITE,439200,488000,29000,517000
2023,District of Oak Bay,80-0255-00,V8S 3G7,208,2100 GRANITE,326200,368000,20700,388700
2023,District of Oak Bay,80-0256-00,V8S 3G7,209,2100 GRANITE,435200,484000,27900,511900
2023,District of Oak Bay,80-0257-00,V8S 3G7,210,2100 GRANITE,344400,387000,20700,407700
2023,District of Oak Bay,80-0258-00,V0R 1T0,211,2100 GRANITE,345400,388000,20700,408700
2023,District of Oak Bay,80-0259-00,V8S 3G7,212,2100 GRANITE,350300,394000,20700,414700
2023,District of Oak Bay,80-0260-00,V8S 3G7,214,2100 GRANITE,410900,463000,20700,483700
2023,District of Oak Bay,80-0261-00,V8S 3G7,315,2100 GRANITE,340900,384000,21500,405500
2023,District of Oak Bay,80-0262-00,V8S 3G7,316,2100 GRANITE,458200,510000,28100,538100
2023,District of Oak Bay,80-0263-00,V8S 3G7,317,2100 GRANITE,353100,396000,22000,418000
2023,District of Oak Bay,80-0264-00,V8S 3G7,301,2100 GRANITE,357500,400000,22600,422600
2023,District of Oak Bay,80-0265-00,V8S 3G7,302,2100 GRANITE,449100,505000,22500,527500
2023,District of Oak Bay,80-0266-00,V8S 3G7,303,2100 GRANITE,349900,392000,22900,414900
2023,District of Oak Bay,80-0267-00,V8S 3G7,304,2100 GRANITE,352900,395000,22900,417900
2023,District of Oak Bay,80-0268-00,V8S 3G7,305,2100 GRANITE,350900,393000,22900,415900
2023,District of Oak Bay,80-0269-00,L7M 0R7,306,2100 GRANITE,352800,395000,22900,417900
2023,District of Oak Bay,80-0270-00,V8S 3G7,307,2100 GRANITE,448400,497000,30300,527300
2023,District of Oak Bay,80-0271-00,V8S 3G7,308,2100 GRANITE,333900,375000,22000,397000
2023,District of Oak Bay,80-0272-00,V8S 5J9,309,2100 GRANITE,444500,493000,29000,522000
2023,District of Oak Bay,80-0272-00,V8S 3G7,309,2100 GRANITE,444500,493000,29000,522000
2023,District of Oak Bay,80-0273-00,V8S 3G7,310,2100 GRANITE,351100,394000,22000,416000
2023,District of Oak Bay,80-0274-00,V0R 1L2,311,2100 GRANITE,352100,395000,22000,417000
2023,District of Oak Bay,80-0275-00,V8S 3G7,312,2100 GRANITE,357900,401000,22000,423000
2023,District of Oak Bay,80-0276-00,V8S 3G7,314,2100 GRANITE,419400,472000,21900,493900
2023,District of Oak Bay,80-0277-00,V0G 1S0,415,2100 GRANITE,350500,396000,22700,418700
2023,District of Oak Bay,80-0277-00,V8V 2L1,415,2100 GRANITE,350500,396000,22700,418700
2023,District of Oak Bay,80-0277-00,V8K 5E6,415,2100 GRANITE,350500,396000,22700,418700
2023,District of Oak Bay,80-0277-00,V8S 3G7,415,2100 GRANITE,350500,396000,22700,418700
2023,District of Oak Bay,80-0278-00,V8S 3G7,416,2100 GRANITE,470900,527000,29500,556500
2023,District of Oak Bay,80-0279-00,V8S 3G7,417,2100 GRANITE,362800,408000,23400,431400
2023,District of Oak Bay,80-0280-00,V8S 3G7,401,2100 GRANITE,367200,413000,24000,437000
2023,District of Oak Bay,80-0281-00,V8S 3G7,402,2100 GRANITE,461100,514000,31700,545700
2023,District of Oak Bay,80-0282-00,V8S 3G7,403,2100 GRANITE,359700,404000,24300,428300
2023,District of Oak Bay,80-0283-00,V8S 3G7,404,2100 GRANITE,362700,407000,24300,431300
2023,District of Oak Bay,80-0284-00,V8S 3G7,405,2100 GRANITE,360700,405000,24200,429200
2023,District of Oak Bay,80-0285-00,,406,2100 GRANITE,362600,407000,24200,431200
2023,District of Oak Bay,80-0286-00,V8S 3G7,407,2100 GRANITE,461000,513000,31600,544600
2023,District of Oak Bay,80-0287-00,V8S 3G7,408,2100 GRANITE,342700,386000,23400,409400
2023,District of Oak Bay,80-0288-00,T3H 2H5,409,2100 GRANITE,456000,509000,30400,539400
2023,District of Oak Bay,80-0289-00,T3E 2G1,410,2100 GRANITE,360800,406000,23300,429300
2023,District of Oak Bay,80-0290-00,V8S 3G7,411,2100 GRANITE,361800,407000,23400,430400
2023,District of Oak Bay,80-0291-00,V8S 3G7,412,2100 GRANITE,367600,414000,23400,437400
2023,District of Oak Bay,80-0292-00,V8S 3G6,414,2100 GRANITE,431000,487000,23300,510300
2023,District of Oak Bay,80-0292-00,V8S 3G6,414,2100 GRANITE,431000,487000,23300,510300
2023,District of Oak Bay,80-0293-00,V8S 5H2,101,1148 GOODWIN,596600,573000,40900,613900
2023,District of Oak Bay,80-0294-00,T3A 1S1,102,1148 GOODWIN,608800,603000,39400,642400
2023,District of Oak Bay,80-0295-00,V8S 5H2,103,1148 GOODWIN,566600,565000,36200,601200
2023,District of Oak Bay,80-0296-00,V8S 5H2,105,1148 GOODWIN,609900,605000,39500,644500
2023,District of Oak Bay,80-0297-00,V8S 5H2,106,1148 GOODWIN,648800,641000,42000,683000
2023,District of Oak Bay,80-0298-00,V8S 5H2,107,1148 GOODWIN,536100,520000,35800,555800
2023,District of Oak Bay,80-0299-00,V8S 5H2,201,1148 GOODWIN,637900,624000,41600,665600
2023,District of Oak Bay,80-0300-00,V8S 5H2,202,1148 GOODWIN,623900,712000,39100,751100
2023,District of Oak Bay,80-0301-00,V8S 5H2,203,1148 GOODWIN,563800,556000,35800,591800
2023,District of Oak Bay,80-0302-00,V8S 5H2,204,1148 GOODWIN,503100,478000,34800,512800
2023,District of Oak Bay,80-0303-00,V8S 5H2,205,1148 GOODWIN,598700,586000,39300,625300
2023,District of Oak Bay,80-0304-00,V8S 5H2,206,1148 GOODWIN,638500,624000,41600,665600
2023,District of Oak Bay,80-0305-00,V8S 5H2,207,1148 GOODWIN,547700,532000,35800,567800
2023,District of Oak Bay,80-0306-00,V8S 5H2,301,1148 GOODWIN,679900,668000,41600,709600
2023,District of Oak Bay,80-0307-00,V8S 5H2,302,1148 GOODWIN,637900,628000,39300,667300
2023,District of Oak Bay,80-0308-00,V8S 5H2,303,1148 GOODWIN,595200,590000,35800,625800
2023,District of Oak Bay,80-0309-00,V8S 5H2,304,1148 GOODWIN,595600,590000,35800,625800
2023,District of Oak Bay,80-0310-00,V8S 5H2,305,1148 GOODWIN,637400,628000,39300,667300
2023,District of Oak Bay,80-0311-00,V8S 5H2,306,1148 GOODWIN,651900,638000,41600,679600
2023,District of Oak Bay,80-0312-00,V8S 5H2,307,1148 GOODWIN,559700,544000,35800,579800
2023,District of Oak Bay,80-0313-00,V8S 5H2,401,1148 GOODWIN,723200,715000,41800,756800
2023,District of Oak Bay,80-0314-00,T6G 1X7,402,1148 GOODWIN,651600,642000,39300,681300
2023,District of Oak Bay,80-0315-00,V8S 5H2,403,1148 GOODWIN,608900,603000,35800,638800
2023,District of Oak Bay,80-0316-00,V8S 5H2,404,1148 GOODWIN,608300,603000,35800,638800
2023,District of Oak Bay,80-0317-00,V8S 5H2,405,1148 GOODWIN,652000,642000,39300,681300
2023,District of Oak Bay,80-0318-00,V8S 5H2,406,1148 GOODWIN,694000,683000,41700,724700
2023,District of Oak Bay,80-0319-00,V8S 5H2,407,1148 GOODWIN,571800,556000,35800,591800
2023,District of Oak Bay,80-0320-00,V8S 5H2,501,1148 GOODWIN,739100,731000,41700,772700
2023,District of Oak Bay,80-0321-00,V8S 5H2,502,1148 GOODWIN,694000,688000,39400,727400
2023,District of Oak Bay,80-0322-00,V8S 5H2,503,1148 GOODWIN,647300,645000,35900,680900
2023,District of Oak Bay,80-0322-00,V8S 5H9,503,1148 GOODWIN,647300,645000,35900,680900
2023,District of Oak Bay,80-0323-00,V8S 5H2,504,1148 GOODWIN,622000,617000,35700,652700
2023,District of Oak Bay,80-0324-00,V3S 8C6,505,1148 GOODWIN,665400,657000,39300,696300
2023,District of Oak Bay,80-0324-00,V8S 5H2,505,1148 GOODWIN,665400,657000,39300,696300
2023,District of Oak Bay,80-0325-00,V8S 5H2,506,1148 GOODWIN,709700,699000,41600,740600
2023,District of Oak Bay,80-0326-00,V8S 5H2,507,1148 GOODWIN,609200,596000,35900,631900
2023,District of Oak Bay,80-0326-01,V8S 5H2,104,1148 GOODWIN,411200,403000,37000,440000
2023,District of Oak Bay,80-0327-00,V8S 2N2,101,1159 BEACH,1537000,1394000,195000,1589000
2023,District of Oak Bay,80-0327-00,V8S 2N2,101,1159 BEACH,1537000,1394000,195000,1589000
2023,District of Oak Bay,80-0327-05,T3C 2L4,502,1159 BEACH,727700,717000,50400,767400
2023,District of Oak Bay,80-0327-07,V8S 2N2,602,1159 BEACH,620600,599000,49900,648900
2023,District of Oak Bay,80-0327-08,V8S 2N2,402,1159 BEACH,642200,622000,50600,672600
2023,District of Oak Bay,80-0329-00,M5J 2B5,103,1159 BEACH,801000,873000,118000,991000
2023,District of Oak Bay,80-0330-00,M5J 2B5,104,1159 BEACH,971000,864000,147000,1011000
2023,District of Oak Bay,80-0331-00,V8S 2N2,201,1159 BEACH,968000,865000,148000,1013000
2023,District of Oak Bay,80-0331-00,T2V 2C8,201,1159 BEACH,968000,865000,148000,1013000
2023,District of Oak Bay,80-0332-00,,202,1159 BEACH,1353000,1176000,220000,1396000
2023,District of Oak Bay,80-0332-00,,202,1159 BEACH,1353000,1176000,220000,1396000
2023,District of Oak Bay,80-0334-00,N6H 4Z2,204,1159 BEACH,994000,890000,147000,1037000
2023,District of Oak Bay,80-0335-00,V8S 2N2,301,1159 BEACH,1000000,896000,149000,1045000
2023,District of Oak Bay,80-0336-00,M5R 1T6,302,1159 BEACH,830000,754000,112000,866000
2023,District of Oak Bay,80-0337-00,M5R 1T6,303,1159 BEACH,819000,744000,111000,855000
2023,District of Oak Bay,80-0338-00,V8S 2N2,304,1159 BEACH,1012000,906000,147000,1053000
2023,District of Oak Bay,80-0339-00,V8S 2N2,306,1159 BEACH,584000,508000,102000,610000
2023,District of Oak Bay,80-0340-00,V8S 2N2,305,1159 BEACH,756000,797000,133000,930000
2023,District of Oak Bay,80-0341-00,V8S 2N2,408,1159 BEACH,768000,669000,133000,802000
2023,District of Oak Bay,80-0342-00,V8W 2C4,403,1159 BEACH,620000,544000,103000,647000
2023,District of Oak Bay,80-0343-01,V8R 6J7,404,1159 BEACH,1146000,1020000,180000,1200000
2023,District of Oak Bay,80-0344-00,V8S 2N2,405,1159 BEACH,1097000,1017000,144000,1161000
2023,District of Oak Bay,80-0345-00,V8S 2N2,406,1159 BEACH,612000,535000,104000,639000
2023,District of Oak Bay,80-0346-00,V4L 2N2,407,1159 BEACH,608000,532000,103000,635000
2023,District of Oak Bay,80-0347-00,V8S 2N2,508,1159 BEACH,785000,685000,133000,818000
2023,District of Oak Bay,80-0348-00,T8A 5P8,501,1159 BEACH,765000,665000,133000,798000
2023,District of Oak Bay,80-0350-00,V8S 2N2,503,1159 BEACH,645000,558000,103000,661000
2023,District of Oak Bay,80-0351-00,V8S 2N2,504,1159 BEACH,1195000,1080000,169000,1249000
2023,District of Oak Bay,80-0352-00,V8S 2N2,505,1159 BEACH,1073000,981000,142000,1123000
2023,District of Oak Bay,80-0352-00,V8S 2N2,505,1159 BEACH,1073000,981000,142000,1123000
2023,District of Oak Bay,80-0353-00,V8S 2N2,506,1159 BEACH,626000,548000,104000,652000
2023,District of Oak Bay,80-0354-00,V8S 2N2,507,1159 BEACH,621000,545000,103000,648000
2023,District of Oak Bay,80-0355-00,V8S 2N2,608,1159 BEACH,802000,718000,118000,836000
2023,District of Oak Bay,80-0356-00,V8S 2N2,601,1159 BEACH,815000,716000,133000,849000
2023,District of Oak Bay,80-0358-00,V8S 2N2,603,1159 BEACH,675000,600000,103000,703000
2023,District of Oak Bay,80-0359-00,T2V 1H7,604,1159 BEACH,1221000,1107000,169000,1276000
2023,District of Oak Bay,80-0360-00,V8S 2V2,605,1159 BEACH,1097000,1004000,142000,1146000
2023,District of Oak Bay,80-0361-00,V4B 1G6,606,1159 BEACH,666000,590000,103000,693000
2023,District of Oak Bay,80-0362-00,V8X 2N2,607,1159 BEACH,661000,587000,103000,690000
2023,District of Oak Bay,80-0363-00,V8S 2N4,101,1211 BEACH,1005800,1206000,59300,1265300
2023,District of Oak Bay,80-0364-00,L9Y 3Y9,102,1211 BEACH,1008900,1314000,48900,1362900
2023,District of Oak Bay,80-0365-00,V8S 2N4,103,1211 BEACH,1135500,1359000,63000,1422000
2023,District of Oak Bay,80-0366-00,V8S 2N4,104,1211 BEACH,1159200,1406000,52900,1458900
2023,District of Oak Bay,80-0367-00,V8S 2N4,105,1211 BEACH,990300,1191000,51900,1242900
2023,District of Oak Bay,80-0368-00,V8S 2N4,106,1211 BEACH,1158300,1425000,55800,1480800
2023,District of Oak Bay,80-0369-00,V0R 2W1,201,1211 BEACH,1662200,1978000,80700,2058700
2023,District of Oak Bay,80-0370-00,V8S 2N4,202,1211 BEACH,1043600,1269000,60100,1329100
2023,District of Oak Bay,80-0371-00,V8S 2N4,203,1211 BEACH,1090600,1324000,63700,1387700
2023,District of Oak Bay,80-0374-00,V8S 2N4,207,1211 BEACH,974400,1181000,53000,1234000
2023,District of Oak Bay,80-0375-00,V8S 2N4,208,1211 BEACH,1035600,1261000,50600,1311600
2023,District of Oak Bay,80-0376-00,V8S 2N4,209,1211 BEACH,1145400,1399000,56600,1455600
2023,District of Oak Bay,80-0377-00,V8S 2N4,210,1211 BEACH,1286400,1573000,61100,1634100
2023,District of Oak Bay,80-0378-00,V8S 2N4,301,1211 BEACH,1392100,1692000,85900,1777900
2023,District of Oak Bay,80-0379-00,V8S 2N4,302,1211 BEACH,1022600,1246000,58100,1304100
2023,District of Oak Bay,80-0380-00,V8S 2N4,303,1211 BEACH,1286700,1567000,64600,1631600
2023,District of Oak Bay,80-0381-00,V8S 2N4,304,1211 BEACH,1728300,2116000,87000,2203000
2023,District of Oak Bay,80-0381-10,V8S 2N4,206,1211 BEACH,1623500,1947000,83800,2030800
2023,District of Oak Bay,80-0381-10,V8S 2N4,206,1211 BEACH,1623500,1947000,83800,2030800
2023,District of Oak Bay,80-0381-10,T3B 3A7,206,1211 BEACH,1623500,1947000,83800,2030800
2023,District of Oak Bay,80-0381-10,T3B 3A7,206,1211 BEACH,1623500,1947000,83800,2030800
2023,District of Oak Bay,80-0381-10,V1N 4L9,206,1211 BEACH,1623500,1947000,83800,2030800
2023,District of Oak Bay,80-0381-10,V1N 4L9,206,1211 BEACH,1623500,1947000,83800,2030800
2023,District of Oak Bay,80-0381-20,V8S 2N4,204,1211 BEACH,1097800,1325000,87300,1412300
2023,District of Oak Bay,80-0382-00,V8R 5N5,,1531 YALE,733000,664000,169000,833000
2023,District of Oak Bay,80-0383-00,V8R 5N5,,1529 YALE,717500,761000,49800,810800
2023,District of Oak Bay,80-0383-00,Y1A 5S9,,1529 YALE,717500,761000,49800,810800
2023,District of Oak Bay,80-0384-00,V6J 4E1,,1527 YALE,717000,642000,168000,810000
2023,District of Oak Bay,80-0385-00,V8R 5N5,,1525 YALE,717000,642000,168000,810000
2023,District of Oak Bay,80-0386-00,V8R 5N5,,1523 YALE,730000,654000,172000,826000
2023,District of Oak Bay,80-0387-00,V8R 1E9,,2132 OAK BAY,659000,595000,153000,748000
2023,District of Oak Bay,80-0388-00,V8R 1E9,,2134 OAK BAY,717000,635000,175000,810000
2023,District of Oak Bay,80-0389-00,V8R 1E9,,2136 OAK BAY,736000,659000,177000,836000
2023,District of Oak Bay,80-0390-00,V8S 4Z2,1,1447 ST. DAVID,838800,938000,40400,978400
2023,District of Oak Bay,80-0391-00,V8S 4Z2,2,1447 ST. DAVID,760800,839000,38700,877700
2023,District of Oak Bay,80-0392-00,V8S 4Z2,3,1447 ST. DAVID,757500,838000,38300,876300
2023,District of Oak Bay,80-0393-00,V8S 4Z2,4,1447 ST. DAVID,778600,862000,38200,900200
2023,District of Oak Bay,80-0394-00,V8S 4Z2,5,1447 ST. DAVID,1103200,1220000,58000,1278000
2023,District of Oak Bay,80-0394-00,V8S 4Z2,5,1447 ST. DAVID,1103200,1220000,58000,1278000
2023,District of Oak Bay,80-0395-00,V8S 4Z2,6,1447 ST. DAVID,1072500,1184000,56400,1240400
2023,District of Oak Bay,80-0396-00,V8R 1E8,101,2125 OAK BAY,738000,631000,129000,760000
2023,District of Oak Bay,80-0397-00,V8R 1E8,102,2125 OAK BAY,738000,633000,130000,763000
2023,District of Oak Bay,80-0398-00,V8R 1E8,103,2125 OAK BAY,741000,651000,117000,768000
2023,District of Oak Bay,80-0399-00,V8R 1E8,104,2125 OAK BAY,521000,461000,82400,543400
2023,District of Oak Bay,80-0400-00,V8R 1E8,105,2125 OAK BAY,742000,649000,119000,768000
2023,District of Oak Bay,80-0401-00,V8R 1E8,106,2125 OAK BAY,750000,647000,128000,775000
2023,District of Oak Bay,80-0402-00,V8R 1E8,107,2125 OAK BAY,734000,629000,128000,757000
2023,District of Oak Bay,80-0403-00,V8R 1E8,108,2125 OAK BAY,699000,608000,117000,725000
2023,District of Oak Bay,80-0404-00,V8R 1E8,201,2125 OAK BAY,751000,644000,128000,772000
2023,District of Oak Bay,80-0405-00,V8R 1E8,202,2125 OAK BAY,753000,648000,129000,777000
2023,District of Oak Bay,80-0406-00,V8R 1E8,203,2125 OAK BAY,761000,671000,118000,789000
2023,District of Oak Bay,80-0407-00,V8R 1E8,204,2125 OAK BAY,535000,474000,82600,556600
2023,District of Oak Bay,80-0408-00,V8T 3A3,205,2125 OAK BAY,759000,762000,136000,898000
2023,District of Oak Bay,80-0408-00,V8T 3A3,205,2125 OAK BAY,759000,762000,136000,898000
2023,District of Oak Bay,80-0409-00,V8R 1E8,206,2125 OAK BAY,766000,663000,128000,791000
2023,District of Oak Bay,80-0410-00,V8S 4W2,207,2125 OAK BAY,751000,644000,128000,772000
2023,District of Oak Bay,80-0410-00,V8R 1E8,207,2125 OAK BAY,751000,644000,128000,772000
2023,District of Oak Bay,80-0411-00,V8R 1E8,208,2125 OAK BAY,833000,715000,143000,858000
2023,District of Oak Bay,80-0412-00,V8R 1E8,301,2125 OAK BAY,767000,661000,128000,789000
2023,District of Oak Bay,80-0413-00,V8R 1E8,302,2125 OAK BAY,769000,665000,129000,794000
2023,District of Oak Bay,80-0414-00,V8R 1E8,303,2125 OAK BAY,778000,687000,118000,805000
2023,District of Oak Bay,80-0415-00,V8R 1E8,304,2125 OAK BAY,546000,486000,82500,568500
2023,District of Oak Bay,80-0416-00,V8R 1E8,305,2125 OAK BAY,780000,688000,119000,807000
2023,District of Oak Bay,80-0416-00,M4G 1M8,305,2125 OAK BAY,780000,688000,119000,807000
2023,District of Oak Bay,80-0417-00,V8R 1E8,306,2125 OAK BAY,785000,683000,128000,811000
2023,District of Oak Bay,80-0418-00,V8R 1E8,307,2125 OAK BAY,767000,661000,128000,789000
2023,District of Oak Bay,80-0419-00,V8R 1E8,308,2125 OAK BAY,851000,733000,143000,876000
2023,District of Oak Bay,80-0420-00,V8R 1E8,401,2125 OAK BAY,788000,686000,129000,815000
2023,District of Oak Bay,80-0421-00,V8R 1E8,402,2125 OAK BAY,791000,690000,130000,820000
2023,District of Oak Bay,80-0422-00,V8R 1E8,403,2125 OAK BAY,799000,713000,118000,831000
2023,District of Oak Bay,80-0423-00,V8R 1E8,404,2125 OAK BAY,561000,504000,83000,587000
2023,District of Oak Bay,80-0424-00,V8R 1E8,405,2125 OAK BAY,802000,714000,119000,833000
2023,District of Oak Bay,80-0425-00,V8R 1E8,406,2125 OAK BAY,792000,693000,128000,821000
2023,District of Oak Bay,80-0426-00,V8R 1E8,407,2125 OAK BAY,788000,686000,129000,815000
2023,District of Oak Bay,80-0427-00,V8V 3K4,408,2125 OAK BAY,875000,762000,144000,906000
2023,District of Oak Bay,80-0428-00,V8R 2N1,103,2323 HAMIOTA,565200,523000,39800,562800
2023,District of Oak Bay,80-0429-00,V8R 2N1,101,2323 HAMIOTA,603900,553000,43100,596100
2023,District of Oak Bay,80-0430-00,V8R 2N1,203,2323 HAMIOTA,681900,630000,43200,673200
2023,District of Oak Bay,80-0431-00,V8R 2N1,201,2323 HAMIOTA,640100,593000,43500,636500
2023,District of Oak Bay,80-0432-00,V8R 2N1,202,2323 HAMIOTA,663900,614000,43300,657300
2023,District of Oak Bay,80-0432-00,V8R 2N1,202,2323 HAMIOTA,663900,614000,43300,657300
2023,District of Oak Bay,80-0433-00,V8R 2N1,204,2323 HAMIOTA,762000,697000,47000,744000
2023,District of Oak Bay,80-0434-00,V8R 2N1,303,2323 HAMIOTA,718400,668000,43400,711400
2023,District of Oak Bay,80-0435-00,V8R 2N1,301,2323 HAMIOTA,673600,629000,43700,672700
2023,District of Oak Bay,80-0436-00,V8R 2N1,302,2323 HAMIOTA,692200,644000,43500,687500
2023,District of Oak Bay,80-0437-00,V8R 2N1,304,2323 HAMIOTA,802400,739000,47200,786200
2023,District of Oak Bay,80-0438-00,V8R 2N1,403,2323 HAMIOTA,759200,717000,43900,760900
2023,District of Oak Bay,80-0439-00,V8R 2N1,401,2323 HAMIOTA,712600,675000,44100,719100
2023,District of Oak Bay,80-0440-00,V8R 2N1,402,2323 HAMIOTA,739200,699000,44000,743000
2023,District of Oak Bay,80-0441-00,V8R 2N1,404,2323 HAMIOTA,848400,794000,47800,841800
2023,District of Oak Bay,80-0459-00,V8S 2G9,,2005 CRESCENT,2175000,1704000,370000,2074000
2023,District of Oak Bay,80-0460-00,V8S 2G9,,2007 CRESCENT,2176000,1704000,371000,2075000
2023,District of Oak Bay,80-0461-00,V8S 5E8,102,1375 NEWPORT,789000,831000,197000,1028000
2023,District of Oak Bay,80-0462-00,V8S 3E8,101,1375 NEWPORT,807000,856000,196000,1052000
2023,District of Oak Bay,80-0462-00,V8S 3E8,101,1375 NEWPORT,807000,856000,196000,1052000
2023,District of Oak Bay,80-0463-00,V4A 9E7,105,1375 NEWPORT,629000,655000,157000,812000
2023,District of Oak Bay,80-0463-00,V8X 0A6,105,1375 NEWPORT,629000,655000,157000,812000
2023,District of Oak Bay,80-0464-00,V8S 5E8,104,1375 NEWPORT,746000,771000,196000,967000
2023,District of Oak Bay,80-0465-00,V8S 5E8,103,1375 NEWPORT,679000,706000,172000,878000
2023,District of Oak Bay,80-0466-00,T2V 1H7,202,1375 NEWPORT,797000,824000,193000,1017000
2023,District of Oak Bay,80-0467-00,V8S 5E8,201,1375 NEWPORT,738000,755000,193000,948000
2023,District of Oak Bay,80-0468-00,V8S 5E8,205,1375 NEWPORT,749000,762000,198000,960000
2023,District of Oak Bay,80-0469-00,V8S 5E8,204,1375 NEWPORT,760000,780000,194000,974000
2023,District of Oak Bay,80-0470-00,V8S 5E8,203,1375 NEWPORT,725000,755000,170000,925000
2023,District of Oak Bay,80-0471-00,V8R 4P7,302,1375 NEWPORT,813000,843000,192000,1035000
2023,District of Oak Bay,80-0472-00,V8S 5E8,301,1375 NEWPORT,751000,767000,193000,960000
2023,District of Oak Bay,80-0473-00,V8S 5E8,305,1375 NEWPORT,759000,773000,197000,970000
2023,District of Oak Bay,80-0474-00,V8S 5E8,304,1375 NEWPORT,777000,799000,193000,992000
2023,District of Oak Bay,80-0475-00,V8S 5E8,303,1375 NEWPORT,741000,772000,169000,941000
2023,District of Oak Bay,80-0476-00,V8S 5E8,402,1375 NEWPORT,829000,860000,192000,1052000
2023,District of Oak Bay,80-0477-00,V8S 5E8,401,1375 NEWPORT,765000,783000,192000,975000
2023,District of Oak Bay,80-0478-00,V8S 5E8,405,1375 NEWPORT,773000,788000,196000,984000
2023,District of Oak Bay,80-0479-00,V8S 5E8,404,1375 NEWPORT,826000,857000,192000,1049000
2023,District of Oak Bay,80-0480-00,V8S 5E8,403,1375 NEWPORT,758000,791000,169000,960000
2023,District of Oak Bay,80-0481-00,V8S 5E8,503,1375 NEWPORT,1225000,1284000,281000,1565000
2023,District of Oak Bay,80-0482-00,V8S 5E8,502,1375 NEWPORT,1014000,1029000,272000,1301000
2023,District of Oak Bay,80-0483-00,V8S 5E8,501,1375 NEWPORT,1197000,1231000,299000,1530000
2023,District of Oak Bay,80-0487-00,V8P 5M8,101,2345 CEDAR HILL CROSS,971000,837000,244000,1081000
2023,District of Oak Bay,80-0488-00,V8P 5M8,102,2345 CEDAR HILL CROSS,965000,835000,243000,1078000
2023,District of Oak Bay,80-0489-00,V8P 5M8,103,2345 CEDAR HILL CROSS,732000,773000,263000,1036000
2023,District of Oak Bay,80-0490-00,V8P 5M8,104,2345 CEDAR HILL CROSS,973000,827000,244000,1071000
2023,District of Oak Bay,80-0491-00,V8P 5M8,105,2345 CEDAR HILL CROSS,723000,761000,264000,1025000
2023,District of Oak Bay,80-0492-00,V8P 5M8,106,2345 CEDAR HILL CROSS,976000,830000,244000,1074000
2023,District of Oak Bay,80-0493-00,V8P 5M8,107,2345 CEDAR HILL CROSS,1046000,897000,260000,1157000
2023,District of Oak Bay,80-0494-00,V8P 5M8,108,2345 CEDAR HILL CROSS,722000,747000,267000,1014000
2023,District of Oak Bay,80-0494-00,V8P 5M8,108,2345 CEDAR HILL CROSS,722000,747000,267000,1014000
2023,District of Oak Bay,80-0495-00,V8P 5M8,109,2345 CEDAR HILL CROSS,987000,850000,244000,1094000
2023,District of Oak Bay,80-0495-00,V8N 2S2,109,2345 CEDAR HILL CROSS,987000,850000,244000,1094000
2023,District of Oak Bay,80-0496-00,V8P 5M8,110,2345 CEDAR HILL CROSS,961000,815000,243000,1058000
2023,District of Oak Bay,80-0497-00,V8P 5M8,111,2345 CEDAR HILL CROSS,707000,726000,269000,995000
2023,District of Oak Bay,80-0498-00,V8P 5M8,112,2345 CEDAR HILL CROSS,1001000,841000,258000,1099000
2023,District of Oak Bay,80-0499-00,V8P 5M8,113,2345 CEDAR HILL CROSS,978000,832000,244000,1076000
2023,District of Oak Bay,80-0500-00,V8P 5M8,114,2345 CEDAR HILL CROSS,734000,763000,266000,1029000
2023,District of Oak Bay,80-0501-00,V8P 5M8,115,2345 CEDAR HILL CROSS,973000,828000,244000,1072000
2023,District of Oak Bay,80-0502-00,V8P 5M8,116,2345 CEDAR HILL CROSS,1049000,901000,260000,1161000
2023,District of Oak Bay,80-0503-00,V8P 5M8,117,2345 CEDAR HILL CROSS,991000,864000,245000,1109000
2023,District of Oak Bay,80-0504-00,V8P 5M8,118,2345 CEDAR HILL CROSS,973000,846000,244000,1090000
2023,District of Oak Bay,80-0505-00,V8P 5M8,119,2345 CEDAR HILL CROSS,714000,748000,265000,1013000
2023,District of Oak Bay,80-0506-00,V8P 5M8,120,2345 CEDAR HILL CROSS,971000,825000,244000,1069000
2023,District of Oak Bay,80-0507-00,V8P 5M8,121,2345 CEDAR HILL CROSS,715000,751000,264000,1015000
2023,District of Oak Bay,80-0508-00,V8P 5M8,122,2345 CEDAR HILL CROSS,968000,822000,244000,1066000
2023,District of Oak Bay,80-0509-00,V8P 5M8,123,2345 CEDAR HILL CROSS,1007000,847000,258000,1105000
2023,District of Oak Bay,80-0510-00,V8P 5M8,124,2345 CEDAR HILL CROSS,716000,738000,267000,1005000
2023,District of Oak Bay,80-0511-00,V8P 5M8,125,2345 CEDAR HILL CROSS,969000,824000,243000,1067000
2023,District of Oak Bay,80-0512-00,V8P 5M8,126,2345 CEDAR HILL CROSS,972000,827000,243000,1070000
2023,District of Oak Bay,80-0513-00,V8P 5M8,127,2345 CEDAR HILL CROSS,717000,740000,267000,1007000
2023,District of Oak Bay,80-0514-00,V8P 5M8,128,2345 CEDAR HILL CROSS,1039000,888000,260000,1148000
2023,District of Oak Bay,80-0515-00,V8P 5M8,129,2345 CEDAR HILL CROSS,1009000,873000,246000,1119000
2023,District of Oak Bay,80-0516-00,V8P 5M8,130,2345 CEDAR HILL CROSS,1003000,844000,258000,1102000
2023,District of Oak Bay,80-0517-00,V8P 5M8,131,2345 CEDAR HILL CROSS,709000,736000,261000,997000
2023,District of Oak Bay,80-0518-00,V8P 5M8,132,2345 CEDAR HILL CROSS,962000,826000,243000,1069000
2023,District of Oak Bay,80-0519-00,V8P 5M8,133,2345 CEDAR HILL CROSS,718000,754000,265000,1019000
2023,District of Oak Bay,80-0520-00,V8P 5M8,134,2345 CEDAR HILL CROSS,985000,856000,245000,1101000
2023,District of Oak Bay,80-0521-00,V8P 5M8,135,2345 CEDAR HILL CROSS,1040000,889000,260000,1149000
2023,District of Oak Bay,80-0522-00,V8P 5M8,136,2345 CEDAR HILL CROSS,719000,743000,268000,1011000
2023,District of Oak Bay,80-0523-00,V8P 5M8,137,2345 CEDAR HILL CROSS,967000,821000,242000,1063000
2023,District of Oak Bay,80-0524-00,V8P 5M8,138,2345 CEDAR HILL CROSS,977000,830000,244000,1074000
2023,District of Oak Bay,80-0525-00,V8P 5M8,139,2345 CEDAR HILL CROSS,981000,790000,284000,1074000
2023,District of Oak Bay,80-0526-00,V8P 5M8,140,2345 CEDAR HILL CROSS,976000,830000,244000,1074000
2023,District of Oak Bay,80-0527-00,V8P 5M8,141,2345 CEDAR HILL CROSS,1005000,845000,258000,1103000
2023,District of Oak Bay,80-0528-00,V8P 5M8,142,2345 CEDAR HILL CROSS,722000,746000,268000,1014000
2023,District of Oak Bay,80-0529-00,T3H 0T7,143,2345 CEDAR HILL CROSS,988000,850000,244000,1094000
2023,District of Oak Bay,80-0530-00,V8P 5M8,144,2345 CEDAR HILL CROSS,991000,854000,244000,1098000
2023,District of Oak Bay,80-0531-00,V8P 5M8,145,2345 CEDAR HILL CROSS,735000,764000,266000,1030000
2023,District of Oak Bay,80-0532-00,V1L 2K3,146,2345 CEDAR HILL CROSS,1001000,840000,258000,1098000
2023,District of Oak Bay,80-0533-00,V8P 5M8,147,2345 CEDAR HILL CROSS,985000,843000,245000,1088000
2023,District of Oak Bay,80-0534-00,V8P 5M8,148,2345 CEDAR HILL CROSS,734000,763000,266000,1029000
2023,District of Oak Bay,80-0535-00,V8P 5M8,149,2345 CEDAR HILL CROSS,976000,829000,244000,1073000
2023,District of Oak Bay,80-0536-00,V8P 5M8,150,2345 CEDAR HILL CROSS,1045000,912000,243000,1155000
2023,District of Oak Bay,80-0537-00,V8P 5M8,151,2345 CEDAR HILL CROSS,1028000,876000,260000,1136000
2023,District of Oak Bay,80-0538-00,V8P 5M8,152,2345 CEDAR HILL CROSS,807000,838000,260000,1098000
2023,District of Oak Bay,80-0539-00,V8P 5M8,153,2345 CEDAR HILL CROSS,997000,852000,243000,1095000
2023,District of Oak Bay,80-0540-00,V8P 5M8,154,2345 CEDAR HILL CROSS,725000,750000,267000,1017000
2023,District of Oak Bay,80-0541-00,V8P 5M8,155,2345 CEDAR HILL CROSS,977000,830000,244000,1074000
2023,District of Oak Bay,80-0542-00,V8P 5M8,156,2345 CEDAR HILL CROSS,1007000,847000,258000,1105000
2023,District of Oak Bay,80-0543-00,V8P 5M8,157,2345 CEDAR HILL CROSS,721000,745000,268000,1013000
2023,District of Oak Bay,80-0544-00,V8P 5M8,158,2345 CEDAR HILL CROSS,1031000,879000,260000,1139000
2023,District of Oak Bay,80-0545-00,V8P 5M8,159,2345 CEDAR HILL CROSS,1030000,877000,260000,1137000
2023,District of Oak Bay,80-0546-00,V8P 5M8,160,2345 CEDAR HILL CROSS,717000,752000,265000,1017000
2023,District of Oak Bay,80-0547-00,V8P 5M8,161,2345 CEDAR HILL CROSS,997000,851000,243000,1094000
2023,District of Oak Bay,80-0548-00,V8P 5M8,162,2345 CEDAR HILL CROSS,725000,761000,265000,1026000
2023,District of Oak Bay,80-0549-00,V8P 5M8,163,2345 CEDAR HILL CROSS,963000,826000,243000,1069000
2023,District of Oak Bay,80-0550-00,V8P 5M8,164,2345 CEDAR HILL CROSS,1026000,886000,259000,1145000
2023,District of Oak Bay,80-0551-00,V8R 5G9,105,2210 CADBORO BAY,591100,543000,46500,589500
2023,District of Oak Bay,80-0552-00,V8R 5G9,101,2210 CADBORO BAY,586800,536000,46800,582800
2023,District of Oak Bay,80-0553-00,V8V 4A1,102,2210 CADBORO BAY,595000,542000,48400,590400
2023,District of Oak Bay,80-0554-00,V8R 5G9,103,2210 CADBORO BAY,592700,531000,50600,581600
2023,District of Oak Bay,80-0555-00,V8R 5G9,104,2210 CADBORO BAY,562300,514000,45400,559400
2023,District of Oak Bay,80-0556-00,V8R 5G9,205,2210 CADBORO BAY,574300,519000,45900,564900
2023,District of Oak Bay,80-0557-00,V8R 5G9,201,2210 CADBORO BAY,583500,528000,46300,574300
2023,District of Oak Bay,80-0558-00,V8R 5G9,202,2210 CADBORO BAY,581500,521000,47700,568700
2023,District of Oak Bay,80-0559-00,V8R 5G9,204,2210 CADBORO BAY,554500,499000,44900,543900
2023,District of Oak Bay,80-0560-00,V8R 5G9,305,2210 CADBORO BAY,595100,542000,46100,588100
2023,District of Oak Bay,80-0561-00,V8R 5G9,301,2210 CADBORO BAY,596400,541000,46400,587400
2023,District of Oak Bay,80-0562-00,V8R 5G9,302,2210 CADBORO BAY,594300,535000,47700,582700
2023,District of Oak Bay,80-0563-00,V8S 3G8,303,2210 CADBORO BAY,596000,528000,50000,578000
2023,District of Oak Bay,80-0564-00,V8R 5G9,304,2210 CADBORO BAY,566300,512000,45000,557000
2023,District of Oak Bay,80-0565-00,V8R 5G9,405,2210 CADBORO BAY,611600,563000,46500,609500
2023,District of Oak Bay,80-0566-00,V8R 5G9,401,2210 CADBORO BAY,612900,563000,46900,609900
2023,District of Oak Bay,80-0567-00,V8R 5G9,402,2210 CADBORO BAY,610600,556000,48200,604200
2023,District of Oak Bay,80-0568-00,V8R 5G9,403,2210 CADBORO BAY,612300,550000,50500,600500
2023,District of Oak Bay,80-0569-00,V8R 5G9,404,2210 CADBORO BAY,581700,532000,45400,577400
2023,District of Oak Bay,80-0570-00,K0K 3L0,102,1280 NEWPORT,748000,730000,173000,903000
2023,District of Oak Bay,80-0571-00,V8S 5E7,101,1280 NEWPORT,789000,754000,190000,944000
2023,District of Oak Bay,80-0572-00,V8X 1C1,202,1280 NEWPORT,779000,761000,177000,938000
2023,District of Oak Bay,80-0573-00,V8S 5E7,201,1280 NEWPORT,809000,790000,186000,976000
2023,District of Oak Bay,80-0574-00,V8S 2T8,302,1280 NEWPORT,937000,957000,180000,1137000
2023,District of Oak Bay,80-0575-00,V8S 5E7,301,1280 NEWPORT,826000,807000,186000,993000
2023,District of Oak Bay,80-0576-00,V8S 5E7,402,1280 NEWPORT,1269000,1295000,253000,1548000
2023,District of Oak Bay,80-0577-00,V0H 1N1,401,1280 NEWPORT,1231000,1251000,246000,1497000
2023,District of Oak Bay,80-0578-00,V8S 2N2,101,1175 NEWPORT,590900,613000,65500,678500
2023,District of Oak Bay,80-0578-00,V0A 1K3,101,1175 NEWPORT,590900,613000,65500,678500
2023,District of Oak Bay,80-0579-00,V8S 5E6,102,1175 NEWPORT,731000,703000,140000,843000
2023,District of Oak Bay,80-0580-00,V8S 5E6,103,1175 NEWPORT,669000,650000,122000,772000
2023,District of Oak Bay,80-0580-00,V8S 5G7,103,1175 NEWPORT,669000,650000,122000,772000
2023,District of Oak Bay,80-0581-00,V8S 5E6,201,1175 NEWPORT,611000,574000,119000,693000
2023,District of Oak Bay,80-0582-00,V8S 5E6,202,1175 NEWPORT,596000,553000,124000,677000
2023,District of Oak Bay,80-0583-00,V8S 5E6,203,1175 NEWPORT,638000,586000,136000,722000
2023,District of Oak Bay,80-0584-00,K7C 2N6,301,1175 NEWPORT,625000,579000,128000,707000
2023,District of Oak Bay,80-0585-00,V8S 5E6,302,1175 NEWPORT,600000,556000,124000,680000
2023,District of Oak Bay,80-0586-00,V8S 5E6,303,1175 NEWPORT,652000,601000,135000,736000
2023,District of Oak Bay,80-0587-00,V8S 5E6,401,1175 NEWPORT,638000,594000,128000,722000
2023,District of Oak Bay,80-0588-00,V8S 5E6,402,1175 NEWPORT,622000,581000,124000,705000
2023,District of Oak Bay,80-0589-00,V8S 5E6,403,1175 NEWPORT,666000,617000,135000,752000
2023,District of Oak Bay,80-0590-00,V8S 5E6,501,1175 NEWPORT,652000,609000,128000,737000
2023,District of Oak Bay,80-0591-00,V8S 5E6,502,1175 NEWPORT,635000,596000,124000,720000
2023,District of Oak Bay,80-0592-00,V8S 5E6,503,1175 NEWPORT,681000,632000,135000,767000
2023,District of Oak Bay,80-0593-00,V8R 2W4,B,2612 THORPE,1469000,1340000,146000,1486000
2023,District of Oak Bay,80-0594-00,V8S 4W5,C,2612 THORPE,1308000,1270000,146000,1416000
2023,District of Oak Bay,80-0594-00,V9K 1M5,C,2612 THORPE,1308000,1270000,146000,1416000
2023,District of Oak Bay,80-0595-00,N0H 2P0,A,2612 THORPE,1397000,1377000,147000,1524000
2023,District of Oak Bay,80-0596-00,V8R 2W4,E,2612 THORPE,1460000,1416000,144000,1560000
2023,District of Oak Bay,80-0597-00,,D,2612 THORPE,1393000,1361000,146000,1507000
2023,District of Oak Bay,80-0598-00,V0R 2W5,101,1370 BEACH,856000,844000,152000,996000
2023,District of Oak Bay,80-0599-00,V8S 2N6,103,1370 BEACH,745000,724000,134000,858000
2023,District of Oak Bay,80-0600-00,V8S 2N6,105,1370 BEACH,745000,724000,134000,858000
2023,District of Oak Bay,80-0601-00,V8S 2N6,109,1370 BEACH,854000,823000,158000,981000
2023,District of Oak Bay,80-0602-00,V8S 2N6,108,1370 BEACH,825000,797000,152000,949000
2023,District of Oak Bay,80-0602-00,T2C 4H2,108,1370 BEACH,825000,797000,152000,949000
2023,District of Oak Bay,80-0603-00,V8S 2N6,111,1370 BEACH,1157000,1116000,220000,1336000
2023,District of Oak Bay,80-0604-00,V8S 2N6,110,1370 BEACH,1157000,1116000,220000,1336000
2023,District of Oak Bay,80-0605-00,V8S 2N6,106,1370 BEACH,963000,934000,180000,1114000
2023,District of Oak Bay,80-0606-00,V8S 2N6,104,1370 BEACH,906000,885000,166000,1051000
2023,District of Oak Bay,80-0607-00,V8S 2N6,102,1370 BEACH,1000000,976000,182000,1158000
2023,District of Oak Bay,80-0608-00,V8S 2N6,201,1370 BEACH,897000,876000,160000,1036000
2023,District of Oak Bay,80-0609-00,V8S 2N6,203,1370 BEACH,755000,734000,134000,868000
2023,District of Oak Bay,80-0610-00,V8S 2N6,205,1370 BEACH,755000,734000,134000,868000
2023,District of Oak Bay,80-0611-00,V8S 2N6,207,1370 BEACH,753000,732000,133000,865000
2023,District of Oak Bay,80-0612-00,V8S 2N6,209,1370 BEACH,860000,826000,158000,984000
2023,District of Oak Bay,80-0613-00,V8S 2N6,208,1370 BEACH,862000,825000,160000,985000
2023,District of Oak Bay,80-0614-00,V8S 2N6,211,1370 BEACH,1153000,1104000,218000,1322000
2023,District of Oak Bay,80-0615-00,V8S 2N6,210,1370 BEACH,1153000,1104000,218000,1322000
2023,District of Oak Bay,80-0616-00,V8S 2N6,206,1370 BEACH,969000,938000,179000,1117000
2023,District of Oak Bay,80-0617-00,V8S 2N6,204,1370 BEACH,902000,874000,164000,1038000
2023,District of Oak Bay,80-0618-00,V8S 2N6,202,1370 BEACH,997000,967000,180000,1147000
2023,District of Oak Bay,80-0619-00,V8S 2N6,301,1370 BEACH,917000,898000,160000,1058000
2023,District of Oak Bay,80-0620-00,V8S 2N6,303,1370 BEACH,772000,752000,134000,886000
2023,District of Oak Bay,80-0621-00,V8S 2N6,305,1370 BEACH,772000,752000,134000,886000
2023,District of Oak Bay,80-0622-00,V8S 2N6,307,1370 BEACH,770000,751000,133000,884000
2023,District of Oak Bay,80-0623-00,V8S 2N6,309,1370 BEACH,879000,848000,157000,1005000
2023,District of Oak Bay,80-0624-00,V8S 2N6,308,1370 BEACH,880000,846000,160000,1006000
2023,District of Oak Bay,80-0625-00,V8S 3Y2,311,1370 BEACH,1178000,1132000,218000,1350000
2023,District of Oak Bay,80-0626-00,V8S 2N6,310,1370 BEACH,1178000,1132000,218000,1350000
2023,District of Oak Bay,80-0627-00,V8S 2N6,306,1370 BEACH,990000,962000,179000,1141000
2023,District of Oak Bay,80-0628-00,V8S 2N6,304,1370 BEACH,922000,896000,164000,1060000
2023,District of Oak Bay,80-0629-00,V8S 2N6,302,1370 BEACH,1019000,991000,180000,1171000
2023,District of Oak Bay,80-0630-00,V8S 2N6,401,1370 BEACH,942000,933000,161000,1094000
2023,District of Oak Bay,80-0631-00,V8S 2N6,403,1370 BEACH,793000,782000,135000,917000
2023,District of Oak Bay,80-0632-00,V8S 2N6,405,1370 BEACH,793000,782000,135000,917000
2023,District of Oak Bay,80-0633-00,V8S 2N6,407,1370 BEACH,790000,780000,134000,914000
2023,District of Oak Bay,80-0634-00,V8S 2N6,409,1370 BEACH,903000,881000,158000,1039000
2023,District of Oak Bay,80-0635-00,V8S 2N6,408,1370 BEACH,905000,880000,161000,1041000
2023,District of Oak Bay,80-0636-00,V8S 2N6,411,1370 BEACH,1210000,1177000,219000,1396000
2023,District of Oak Bay,80-0637-00,V8S 2N6,410,1370 BEACH,1210000,1177000,219000,1396000
2023,District of Oak Bay,80-0638-00,V8S 2N6,406,1370 BEACH,1018000,1000000,180000,1180000
2023,District of Oak Bay,80-0638-00,V8S 4H4,406,1370 BEACH,1018000,1000000,180000,1180000
2023,District of Oak Bay,80-0639-00,V8S 2N6,404,1370 BEACH,947000,931000,165000,1096000
2023,District of Oak Bay,80-0640-00,V8S 2N6,402,1370 BEACH,1027000,1006000,181000,1187000
2023,District of Oak Bay,80-0641-00,V8R 1E8,102,2119 OAK BAY,801000,778000,128000,906000
2023,District of Oak Bay,80-0642-00,V8R 3E8,101,2119 OAK BAY,780000,777000,124000,901000
2023,District of Oak Bay,80-0643-00,V8R 1E8,108,2119 OAK BAY,862000,811000,133000,944000
2023,District of Oak Bay,80-0644-00,V8R 1E8,107,2119 OAK BAY,829000,769000,122000,891000
2023,District of Oak Bay,80-0645-00,V8R 1E8,106,2119 OAK BAY,833000,773000,122000,895000
2023,District of Oak Bay,80-0646-00,V8R 1E8,105,2119 OAK BAY,860000,810000,133000,943000
2023,District of Oak Bay,80-0647-00,V8R 1E8,104,2119 OAK BAY,805000,810000,133000,943000
2023,District of Oak Bay,80-0648-00,V8R 1E8,103,2119 OAK BAY,793000,771000,127000,898000
2023,District of Oak Bay,80-0649-00,V8R 1E8,202,2119 OAK BAY,795000,769000,123000,892000
2023,District of Oak Bay,80-0650-00,V8R 1E8,201,2119 OAK BAY,813000,762000,123000,885000
2023,District of Oak Bay,80-0651-00,V8R 1E8,208,2119 OAK BAY,853000,796000,132000,928000
2023,District of Oak Bay,80-0652-00,V8R 1E8,207,2119 OAK BAY,850000,782000,126000,908000
2023,District of Oak Bay,80-0653-00,V8R 1E8,206,2119 OAK BAY,865000,794000,129000,923000
2023,District of Oak Bay,80-0654-00,V8R 1E8,205,2119 OAK BAY,853000,794000,132000,926000
2023,District of Oak Bay,80-0655-00,V8R 1E8,204,2119 OAK BAY,853000,794000,132000,926000
2023,District of Oak Bay,80-0656-00,V8R 1E8,203,2119 OAK BAY,787000,758000,126000,884000
2023,District of Oak Bay,80-0657-00,V8R 1E8,302,2119 OAK BAY,811000,782000,127000,909000
2023,District of Oak Bay,80-0658-00,V8R 1E8,301,2119 OAK BAY,830000,779000,123000,902000
2023,District of Oak Bay,80-0659-00,V8R 1E8,308,2119 OAK BAY,871000,813000,131000,944000
2023,District of Oak Bay,80-0660-00,V8R 1E8,307,2119 OAK BAY,867000,799000,125000,924000
2023,District of Oak Bay,80-0661-00,V8R 1E8,306,2119 OAK BAY,883000,812000,129000,941000
2023,District of Oak Bay,80-0662-00,V8R 1E8,305,2119 OAK BAY,869000,812000,131000,943000
2023,District of Oak Bay,80-0663-00,V8R 1E8,304,2119 OAK BAY,869000,812000,131000,943000
2023,District of Oak Bay,80-0664-00,V8R 1E8,303,2119 OAK BAY,803000,775000,126000,901000
2023,District of Oak Bay,80-0665-00,V8R 1E8,402,2119 OAK BAY,831000,809000,128000,937000
2023,District of Oak Bay,80-0666-00,V8R 1E8,401,2119 OAK BAY,851000,805000,124000,929000
2023,District of Oak Bay,80-0667-00,V8R 1E8,408,2119 OAK BAY,894000,842000,132000,974000
2023,District of Oak Bay,80-0668-00,,407,2119 OAK BAY,890000,827000,126000,953000
2023,District of Oak Bay,80-0669-00,V8R 1E8,406,2119 OAK BAY,905000,840000,129000,969000
2023,District of Oak Bay,80-0670-00,V8R 1E8,405,2119 OAK BAY,892000,840000,132000,972000
2023,District of Oak Bay,80-0671-00,V8R 1E8,404,2119 OAK BAY,892000,840000,132000,972000
2023,District of Oak Bay,80-0672-00,V9R 1E8,403,2119 OAK BAY,824000,802000,126000,928000
2023,District of Oak Bay,80-0672-00,V8R 1E8,403,2119 OAK BAY,824000,802000,126000,928000
2023,District of Oak Bay,80-0673-00,V8S 2T7,,627 ISLAND,2194000,1868000,739000,2607000
2023,District of Oak Bay,80-0673-00,V6K 1R7,,627 ISLAND,2194000,1868000,739000,2607000
2023,District of Oak Bay,80-0674-00,V8S 2T7,,623 ISLAND,1909000,1869000,433000,2302000
2023,District of Oak Bay,80-0675-00,V8S 2T7,,619 ISLAND,2231000,1878000,808000,2686000
2023,District of Oak Bay,80-0676-00,V8S 2T7,,615 ISLAND,1937000,1851000,468000,2319000
2023,District of Oak Bay,80-0677-00,V8S 2T7,,611 ISLAND,2191000,1895000,605000,2500000
2023,District of Oak Bay,80-0678-00,V8S 2T7,,607 ISLAND,2268000,1886000,850000,2736000
2023,District of Oak Bay,80-0679-00,V8S 2T7,,603 ISLAND,2223000,1903000,768000,2671000
2023,District of Oak Bay,80-0680-00,V8S 2T7,,599 ISLAND,3227000,2120000,1664000,3784000
2023,District of Oak Bay,80-0681-00,V8S 2T7,,595 ISLAND,2504000,1928000,1061000,2989000
2023,District of Oak Bay,80-0682-00,V8S 2T7,,591 ISLAND,2889000,1850000,1626000,3476000
2023,District of Oak Bay,80-0683-00,V8R 2W2,,2320 ESPLANADE,747000,899000,175000,1074000
2023,District of Oak Bay,80-0684-00,V8R 2W2,,2330 ESPLANADE,746000,889000,185000,1074000
2023,District of Oak Bay,80-0685-00,V8R 2W2,,2322 ESPLANADE,903000,1083000,227000,1310000
2023,District of Oak Bay,80-0686-00,V8R 2W2,,2328 ESPLANADE,903000,1083000,227000,1310000
2023,District of Oak Bay,80-0687-00,V8R 2W2,,2324 ESPLANADE,793000,947000,188000,1135000
2023,District of Oak Bay,80-0688-00,T1W 2P5,,2326 ESPLANADE,810000,970000,188000,1158000
2023,District of Oak Bay,80-0689-00,V8S 4K2,,203 DENISON,2099000,1936000,591000,2527000
2023,District of Oak Bay,80-0690-00,V8S 4K2,,205 DENISON,1916000,1937000,376000,2313000
2023,District of Oak Bay,80-0691-00,V8S 4K2,,207 DENISON,2468000,2137000,823000,2960000
2023,District of Oak Bay,80-0692-00,V8S 4K2,,209 DENISON,2254000,1936000,776000,2712000
2023,District of Oak Bay,80-0693-00,V8S 4K2,,211 DENISON,2269000,1937000,778000,2715000
2023,District of Oak Bay,80-0694-00,V8S 4K2,,213 DENISON,2379000,1936000,928000,2864000
2023,District of Oak Bay,80-0695-00,V8S 3G6,,2114 GRANITE,1018000,936000,176000,1112000
2023,District of Oak Bay,80-0696-00,V8S 3G6,,2116 GRANITE,1001000,904000,183000,1087000
2023,District of Oak Bay,80-0697-00,V8S 3G6,,2118 GRANITE,1013000,921000,172000,1093000
2023,District of Oak Bay,80-0698-00,V8S 3G6,,2126 GRANITE,1029000,933000,178000,1111000
2023,District of Oak Bay,80-0699-00,V8S 3G6,,2128 GRANITE,1020000,915000,200000,1115000
2023,District of Oak Bay,80-0700-00,V8S 3G6,,2130 GRANITE,1020000,915000,199000,1114000
2023,District of Oak Bay,80-0701-00,V8S 3G6,,2132 GRANITE,1057000,953000,194000,1147000
2023,District of Oak Bay,80-0702-00,V8S 3G6,,2134 GRANITE,1012000,921000,171000,1092000
2023,District of Oak Bay,80-0703-00,T2T 3B3,,2136 GRANITE,1096000,961000,250000,1211000
2023,District of Oak Bay,80-0703-00,T2E 2C9,,2136 GRANITE,1096000,961000,250000,1211000
2023,District of Oak Bay,80-0703-00,V8S 3G6,,2136 GRANITE,1096000,961000,250000,1211000
2023,District of Oak Bay,80-0704-00,V8S 3G6,,2138 GRANITE,1096000,980000,238000,1218000
2023,District of Oak Bay,80-0705-00,V8S 5K6,,1405 YALE,1119000,993000,252000,1245000
2023,District of Oak Bay,80-0706-00,V8S 5K6,,1409 YALE,1018000,914000,199000,1113000
2023,District of Oak Bay,80-0707-00,V8S 5K6,,1413 YALE,1064000,943000,228000,1171000
2023,District of Oak Bay,80-0708-00,V8S 5K6,,1417 YALE,1077000,1001000,173000,1174000
2023,District of Oak Bay,80-0709-00,V8S 5K6,,1421 YALE,1077000,968000,206000,1174000
2023,District of Oak Bay,80-0710-00,V8S 5K6,,1423 YALE,1047000,948000,202000,1150000
2023,District of Oak Bay,80-0711-00,V8S 5K6,,1425 YALE,1118000,992000,251000,1243000
2023,District of Oak Bay,80-0712-00,V8S 3G6,,2124 GRANITE,1010000,923000,181000,1104000
2023,District of Oak Bay,80-0713-00,V8S 3G6,,2122 GRANITE,1120000,994000,252000,1246000
2023,District of Oak Bay,80-0714-00,V8S 4K5,, DENISON,241000,259000,0,259000
2023,District of Oak Bay,80-0715-00,V8S 4K5,,382 DENISON,904000,772000,306000,1078000
2023,District of Oak Bay,80-0716-00,V8S 5C5,,386 NEWPORT,5720000,3314000,3102000,6416000
2023,District of Oak Bay,80-0717-00,V8S 5C5,,454 NEWPORT,3708000,3438000,1013000,4451000
2023,District of Oak Bay,80-0718-00,V8S 5C5,,432 NEWPORT,3867000,3214000,1490000,4704000
2023,District of Oak Bay,80-0719-00,V8S 5C5,,416 NEWPORT,3950000,3481000,1272000,4753000
2023,District of Oak Bay,80-0720-00,V8S 5C5,,408 NEWPORT,3685000,3247000,1216000,4463000
2023,District of Oak Bay,80-0721-00,V8S 2L6,,161 BEACH,1793000,1714000,449000,2163000
2023,District of Oak Bay,80-0722-00,V8S 2L6,,163 BEACH,2093000,1747000,763000,2510000
2023,District of Oak Bay,80-0722-00,V8S 2L6,,163 BEACH,2093000,1747000,763000,2510000
2023,District of Oak Bay,80-0723-00,V8S 2J8,,341 KING GEORGE,2151000,1839000,652000,2491000
2023,District of Oak Bay,80-0724-00,V8S 2J8,,339 KING GEORGE,3013000,2172000,645000,2817000
2023,District of Oak Bay,80-0725-00,V8S 2J8,,337 KING GEORGE,3203000,2172000,834000,3006000
2023,District of Oak Bay,80-0726-00,V8S 2J8,,335 KING GEORGE,2144000,1817000,681000,2498000
2023,District of Oak Bay,80-0727-00,V9A 2W8,101,1477 YALE,767000,706000,137000,843000
2023,District of Oak Bay,80-0728-00,V8S 4R3,102,1477 YALE,788000,729000,136000,865000
2023,District of Oak Bay,80-0729-00,V8S 4R3,103,1477 YALE,713000,651000,138000,789000
2023,District of Oak Bay,80-0730-00,V8S 4R3,104,1477 YALE,790000,738000,138000,876000
2023,District of Oak Bay,80-0731-00,V8S 4R3,105,1477 YALE,763000,705000,138000,843000
2023,District of Oak Bay,80-0732-00,V8S 4R3,201,1477 YALE,744000,673000,135000,808000
2023,District of Oak Bay,80-0733-00,V8S 4R3,202,1477 YALE,762000,693000,135000,828000
2023,District of Oak Bay,80-0734-00,V8S 4R3,203,1477 YALE,688000,615000,136000,751000
2023,District of Oak Bay,80-0735-00,V8S 4R3,204,1477 YALE,758000,690000,136000,826000
2023,District of Oak Bay,80-0736-00,V8S 2P7,205,1477 YALE,737000,668000,136000,804000
2023,District of Oak Bay,80-0736-00,V8S 4R3,205,1477 YALE,737000,668000,136000,804000
2023,District of Oak Bay,80-0737-00,V8S 4R3,301,1477 YALE,713000,643000,136000,779000
2023,District of Oak Bay,80-0738-00,V8S 4R3,302,1477 YALE,736000,669000,136000,805000
2023,District of Oak Bay,80-0739-00,V8S 4R3,303,1477 YALE,709000,640000,137000,777000
2023,District of Oak Bay,80-0740-00,V8S 4R3,304,1477 YALE,778000,716000,137000,853000
2023,District of Oak Bay,80-0741-00,V8S 4R3,305,1477 YALE,761000,699000,137000,836000
2023,District of Oak Bay,80-0742-00,V8S 3G6,,2120 GRANITE,1001000,905000,165000,1070000
2023,District of Oak Bay,80-0743-00,V8S 3G6,,2112 GRANITE,1027000,936000,170000,1106000
2023,District of Oak Bay,80-0744-00,V8R 5X1,,1615 YORK,2471000,1946000,837000,2783000
2023,District of Oak Bay,80-0745-00,V8R 5X1,,1625 YORK,2352000,1918000,712000,2630000
2023,District of Oak Bay,80-0746-00,V8R 5X1,,1635 YORK,2429000,1865000,847000,2712000
2023,District of Oak Bay,80-0747-00,V8R 5X1,,1645 YORK,2475000,1940000,840000,2780000
2023,District of Oak Bay,80-0748-00,V8R 5X2,,1660 YORK,2111000,1740000,521000,2261000
2023,District of Oak Bay,80-0749-00,V8R 5X2,,1650 YORK,2476000,1859000,896000,2755000
2023,District of Oak Bay,80-0750-00,V8R 5X2,,1640 YORK,2680000,1881000,1153000,3034000
2023,District of Oak Bay,80-0751-00,V8R 5X2,,1630 YORK,3520000,2331000,1527000,3858000
2023,District of Oak Bay,80-0752-00,V8R 5T6,,1676 HAMPSHIRE,1622000,1203000,610000,1813000
2023,District of Oak Bay,80-0753-00,V8R 5T6,,1674 HAMPSHIRE,1698000,1223000,675000,1898000
2023,District of Oak Bay,80-0754-00,V8R 5T6,,1672 HAMPSHIRE,1617000,1209000,598000,1807000
2023,District of Oak Bay,80-0755-00,V8R 5T6,,1670 HAMPSHIRE,1626000,1169000,648000,1817000
2023,District of Oak Bay,80-0756-00,V8V 3K9,,1668 HAMPSHIRE,1617000,1292000,482000,1774000
2023,District of Oak Bay,80-0757-00,V8R 5T6,,1666 HAMPSHIRE,1678000,1200000,689000,1889000
2023,District of Oak Bay,80-0758-00,V8R 5T6,,1664 HAMPSHIRE,1284000,1123000,285000,1408000
2023,District of Oak Bay,80-0759-00,V8R 5T6,,1662 HAMPSHIRE,1627000,1157000,666000,1823000
2023,District of Oak Bay,80-0760-00,V8R 5T6,,1660 HAMPSHIRE,1602000,1155000,646000,1801000
2023,District of Oak Bay,80-0768-00,V8R 1G6,101,2277 OAK BAY,906000,800000,383000,1183000
2023,District of Oak Bay,80-0769-00,V8R 1G6,102,2277 OAK BAY,886000,798000,350000,1148000
2023,District of Oak Bay,80-0770-00,V8R 1G6,103,2277 OAK BAY,930000,843000,356000,1199000
2023,District of Oak Bay,80-0771-00,V8R 1G6,104,2277 OAK BAY,997000,893000,401000,1294000
2023,District of Oak Bay,80-0771-00,V8R 1G6,104,2277 OAK BAY,997000,893000,401000,1294000
2023,District of Oak Bay,80-0772-00,V8R 1G6,105,2277 OAK BAY,950000,854000,371000,1225000
2023,District of Oak Bay,80-0773-00,V8R 1G6,106,2277 OAK BAY,1048000,947000,401000,1348000
2023,District of Oak Bay,80-0774-00,V8R 1G6,107,2277 OAK BAY,981000,876000,399000,1275000
2023,District of Oak Bay,80-0775-00,V8R 1G6,108,2277 OAK BAY,992000,888000,402000,1290000
2023,District of Oak Bay,80-0776-00,V8R 1G6,201,2277 OAK BAY,915000,809000,381000,1190000
2023,District of Oak Bay,80-0776-00,V8R 1G6,201,2277 OAK BAY,915000,809000,381000,1190000
2023,District of Oak Bay,80-0777-00,V9P 9C9,202,2277 OAK BAY,890000,799000,349000,1148000
2023,District of Oak Bay,80-0778-00,V8R 1G6,203,2277 OAK BAY,946000,859000,353000,1212000
2023,District of Oak Bay,80-0779-00,V8R 1G6,204,2277 OAK BAY,977000,865000,400000,1265000
2023,District of Oak Bay,80-0780-00,V8R 1G6,205,2277 OAK BAY,976000,883000,369000,1252000
2023,District of Oak Bay,80-0781-00,V8R 1G6,206,2277 OAK BAY,1053000,951000,399000,1350000
2023,District of Oak Bay,80-0782-00,V8Y 3B1,207,2277 OAK BAY,981000,872000,397000,1269000
2023,District of Oak Bay,80-0782-00,V8Y 1Z4,207,2277 OAK BAY,981000,872000,397000,1269000
2023,District of Oak Bay,80-0782-00,V8R 1G6,207,2277 OAK BAY,981000,872000,397000,1269000
2023,District of Oak Bay,80-0783-00,V8R 1G6,208,2277 OAK BAY,975000,863000,401000,1264000
2023,District of Oak Bay,80-0784-00,V8R 1G6,PH1,2277 OAK BAY,941000,842000,381000,1223000
2023,District of Oak Bay,80-0785-00,V8R 1G6,PH2,2277 OAK BAY,915000,831000,349000,1180000
2023,District of Oak Bay,80-0786-00,V8R 1G6,PH3,2277 OAK BAY,972000,893000,353000,1246000
2023,District of Oak Bay,80-0787-00,V8R 1G6,PH4,2277 OAK BAY,1023000,922000,399000,1321000
2023,District of Oak Bay,80-0788-00,,PH5,2277 OAK BAY,985000,896000,370000,1266000
2023,District of Oak Bay,80-0789-00,V8R 1G6,PH6,2277 OAK BAY,1082000,988000,399000,1387000
2023,District of Oak Bay,80-0790-00,V8R 1G6,PH7,2277 OAK BAY,1009000,907000,397000,1304000
2023,District of Oak Bay,80-0790-00,V8R 1G6,PH7,2277 OAK BAY,1009000,907000,397000,1304000
2023,District of Oak Bay,80-0791-00,V8R 1G6,PH8,2277 OAK BAY,1021000,920000,400000,1320000
2023,District of Oak Bay,80-0792-00,V8R 5J2,,2580 CADBORO BAY,952000,893000,176000,1069000
2023,District of Oak Bay,80-0793-00,V8R 5J2,,2570 CADBORO BAY,945000,880000,175000,1055000
2023,District of Oak Bay,80-0794-00,V8X 5E4,,2560 CADBORO BAY,942000,879000,175000,1054000
2023,District of Oak Bay,80-0795-00,V1J 3P3,,2550 CADBORO BAY,944000,880000,175000,1055000
2023,District of Oak Bay,80-0796-00,V8R 5J2,,2540 CADBORO BAY,951000,891000,176000,1067000
2023,District of Oak Bay,80-0797-00,T3A 0C4,,2260 KINROSS,928000,877000,175000,1052000
2023,District of Oak Bay,80-0798-00,V8R 2N5,,2270 KINROSS,963000,904000,176000,1080000
2023,District of Oak Bay,80-0799-00,V8S 4J7,,0 MOUNTJOY,446000,346000,187000,533000
2023,District of Oak Bay,80-0800-00,V8R 1E7,,2130 OAK BAY,1182000,1143000,205000,1348000
2023,District of Oak Bay,80-0801-00,V8R 5N4,,1522 YALE,1153000,1092000,204000,1296000
2023,District of Oak Bay,80-0802-00,V8R 5N4,,1524 YALE,1145000,1082000,204000,1286000
2023,District of Oak Bay,80-0802-00,K9H 5S9,,1524 YALE,1145000,1082000,204000,1286000
2023,District of Oak Bay,80-0803-00,V8R 5N4,,1526 YALE,1145000,1082000,204000,1286000
2023,District of Oak Bay,80-0804-00,V8R 5N4,,1528 YALE,1172000,1117000,205000,1322000
2023,District of Oak Bay,80-0805-00,V8S 2N3,101,1284 BEACH,1104000,1191000,274000,1465000
2023,District of Oak Bay,80-0806-00,V8S 2N3,102,1284 BEACH,1407000,1649000,292000,1941000
2023,District of Oak Bay,80-0807-00,V8S 2N3,103,1284 BEACH,1854000,2135000,386000,2521000
2023,District of Oak Bay,80-0808-00,V6Z 3G1,104,1284 BEACH,1473000,1756000,294000,2050000
2023,District of Oak Bay,80-0809-00,V8S 2N3,105,1284 BEACH,1282000,1493000,271000,1764000
2023,District of Oak Bay,80-0810-00,V8N 1L6,201,1284 BEACH,1088000,1153000,270000,1423000
2023,District of Oak Bay,80-0811-00,V8S 2N3,202,1284 BEACH,1393000,1609000,289000,1898000
2023,District of Oak Bay,80-0812-00,V8S 2N3,203,1284 BEACH,1870000,2149000,385000,2534000
2023,District of Oak Bay,80-0813-00,V8S 2N3,204,1284 BEACH,1449000,1697000,290000,1987000
2023,District of Oak Bay,80-0814-00,V8S 2N3,205,1284 BEACH,1327000,1516000,284000,1800000
2023,District of Oak Bay,80-0815-00,V8S 2N3,301,1284 BEACH,1119000,1207000,273000,1480000
2023,District of Oak Bay,80-0816-00,V8S 2N3,302,1284 BEACH,1431000,1680000,292000,1972000
2023,District of Oak Bay,80-0817-00,V8S 3E3,303,1284 BEACH,1921000,2244000,389000,2633000
2023,District of Oak Bay,80-0818-00,T2R 0C5,304,1284 BEACH,1489000,1771000,293000,2064000
2023,District of Oak Bay,80-0819-00,V8S 2N3,305,1284 BEACH,1364000,1584000,287000,1871000
2023,District of Oak Bay,80-0819-00,V8S 4P3,305,1284 BEACH,1364000,1584000,287000,1871000
2023,District of Oak Bay,80-0820-00,V8S 5H9,104,2605 WINDSOR,611000,583000,53800,636800
2023,District of Oak Bay,80-0821-00,V8S 5H9,103,2605 WINDSOR,427700,415000,35800,450800
2023,District of Oak Bay,80-0822-00,V8S 5H9,102,2605 WINDSOR,490500,468000,42800,510800
2023,District of Oak Bay,80-0823-00,V8S 5H9,101,2605 WINDSOR,586300,563000,50900,613900
2023,District of Oak Bay,80-0824-00,V8S 5H9,204,2605 WINDSOR,639600,600000,56900,656900
2023,District of Oak Bay,80-0825-00,V8S 5H9,203,2605 WINDSOR,515000,491000,44400,535400
2023,District of Oak Bay,80-0826-00,V8S 5H9,202,2605 WINDSOR,504200,483000,43400,526400
2023,District of Oak Bay,80-0827-00,V8X 1C1,201,2605 WINDSOR,590800,560000,51300,611300
2023,District of Oak Bay,80-0828-00,V8S 5H9,304,2605 WINDSOR,653100,615000,57000,672000
2023,District of Oak Bay,80-0829-00,V8S 5H9,303,2605 WINDSOR,526800,504000,44600,548600
2023,District of Oak Bay,80-0830-00,V8S 5H9,302,2605 WINDSOR,515700,495000,43400,538400
2023,District of Oak Bay,80-0831-00,V8S 5H9,301,2605 WINDSOR,603200,575000,51400,626400
2023,District of Oak Bay,80-0832-00,V8S 5H9,403,2605 WINDSOR,1003000,820000,177000,997000
2023,District of Oak Bay,80-0833-00,V8S 5H9,402,2605 WINDSOR,466100,426000,69300,495300
2023,District of Oak Bay,80-0834-00,V8S 5H9,401,2605 WINDSOR,713400,668000,62200,730200
2023,District of Oak Bay,80-0834-00,V8S 5H9,401,2605 WINDSOR,713400,668000,62200,730200
2023,District of Oak Bay,80-0835-00,V8S 5H9,503,2605 WINDSOR,1066000,972000,99300,1071300
2023,District of Oak Bay,80-0836-00,V8S 5H9,501,2605 WINDSOR,1011000,849000,174000,1023000
